;Seq_4;Seq_3;Seq_2;Seq_1;Seq_0;diff;fact_count;pre_count;prob
0;3;6;4;2;1;-1;1;2;0.50
1;3;6;4;2;5;3;1;2;0.50
2;8;8;4;4;1;-3;1;2;0.50
3;8;8;4;4;6;2;1;2;0.50
4;5;4;5;4;1;-3;1;7;0.14
5;5;4;5;4;2;-2;1;7;0.14
6;5;4;5;4;3;-1;1;7;0.14
7;5;4;5;4;4;0;1;7;0.14
8;5;4;5;4;5;1;1;7;0.14
9;5;4;5;4;6;2;1;7;0.14
10;5;4;5;4;8;4;1;7;0.14
11;8;5;5;4;1;-3;1;1;1.00
12;5;7;5;4;1;-3;1;10;0.10
13;5;7;5;4;4;0;1;10;0.10
14;5;7;5;4;5;1;2;10;0.20
15;5;7;5;4;6;2;2;10;0.20
16;5;7;5;4;7;3;4;10;0.40
17;4;5;7;4;1;-3;1;2;0.50
18;4;5;7;4;6;2;1;2;0.50
19;5;6;2;5;1;-4;1;1;1.00
20;3;3;5;5;1;-4;1;1;1.00
21;4;6;6;5;1;-4;1;6;0.17
22;4;6;6;5;2;-3;1;6;0.17
23;4;6;6;5;4;-1;1;6;0.17
24;4;6;6;5;5;0;2;6;0.33
25;4;6;6;5;6;1;1;6;0.17
26;5;6;7;5;1;-4;1;9;0.11
27;5;6;7;5;4;-1;3;9;0.33
28;5;6;7;5;5;0;2;9;0.22
29;5;6;7;5;6;1;2;9;0.22
30;5;6;7;5;8;3;1;9;0.11
31;4;4;9;5;1;-4;1;2;0.50
32;4;4;9;5;6;1;1;2;0.50
33;7;3;3;6;1;-5;1;1;1.00
34;5;6;3;7;1;-6;1;2;0.50
35;5;6;3;7;8;1;1;2;0.50
36;7;7;3;7;1;-6;1;1;1.00
37;6;5;6;8;1;-7;1;3;0.33
38;6;5;6;8;6;-2;1;3;0.33
39;6;5;6;8;7;-1;1;3;0.33
40;5;5;5;9;1;-8;1;1;1.00
41;8;6;6;9;1;-8;1;1;1.00
42;8;4;4;1;2;1;1;1;1.00
43;5;3;2;2;2;0;1;1;1.00
44;7;5;3;2;2;0;1;1;1.00
45;5;9;5;2;2;0;1;1;1.00
46;4;5;4;3;2;-1;1;3;0.33
47;4;5;4;3;5;2;1;3;0.33
48;4;5;4;3;7;4;1;3;0.33
49;4;6;4;3;2;-1;1;3;0.33
50;4;6;4;3;3;0;1;3;0.33
51;4;6;4;3;4;1;1;3;0.33
52;8;5;5;3;2;-1;1;2;0.50
53;8;5;5;3;4;1;1;2;0.50
54;7;7;5;3;2;-1;1;1;1.00
55;5;5;6;3;2;-1;2;7;0.29
56;5;5;6;3;4;1;3;7;0.43
57;5;5;6;3;5;2;1;7;0.14
58;5;5;6;3;7;4;1;7;0.14
59;5;6;6;3;2;-1;1;2;0.50
60;5;6;6;3;9;6;1;2;0.50
61;5;6;7;3;2;-1;1;1;1.00
62;6;7;7;3;2;-1;1;1;1.00
63;5;6;3;4;2;-2;1;5;0.20
64;5;6;3;4;3;-1;2;5;0.40
65;5;6;3;4;7;3;1;5;0.20
66;5;6;3;4;10;6;1;5;0.20
67;3;4;5;4;2;-2;1;2;0.50
68;3;4;5;4;8;4;1;2;0.50
69;5;6;5;4;2;-2;1;5;0.20
70;5;6;5;4;4;0;1;5;0.20
71;5;6;5;4;5;1;2;5;0.40
72;5;6;5;4;6;2;1;5;0.20
73;3;3;6;4;2;-2;1;1;1.00
74;4;3;6;4;2;-2;1;2;0.50
75;4;3;6;4;5;1;1;2;0.50
76;6;5;6;4;2;-2;1;5;0.20
77;6;5;6;4;5;1;1;5;0.20
78;6;5;6;4;6;2;2;5;0.40
79;6;5;6;4;8;4;1;5;0.20
80;6;6;6;4;2;-2;1;6;0.17
81;6;6;6;4;5;1;1;6;0.17
82;6;6;6;4;6;2;1;6;0.17
83;6;6;6;4;7;3;1;6;0.17
84;6;6;6;4;8;4;2;6;0.33
85;8;4;7;4;2;-2;1;1;1.00
86;9;5;7;4;2;-2;1;2;0.50
87;9;5;7;4;4;0;1;2;0.50
88;5;7;3;5;2;-3;1;4;0.25
89;5;7;3;5;4;-1;1;4;0.25
90;5;7;3;5;5;0;1;4;0.25
91;5;7;3;5;6;1;1;4;0.25
92;6;7;3;5;2;-3;1;1;1.00
93;6;4;4;5;2;-3;1;4;0.25
94;6;4;4;5;3;-2;2;4;0.50
95;6;4;4;5;4;-1;1;4;0.25
96;6;5;4;5;2;-3;1;8;0.12
97;6;5;4;5;4;-1;2;8;0.25
98;6;5;4;5;5;0;1;8;0.12
99;6;5;4;5;6;1;2;8;0.25
100;6;5;4;5;7;2;2;8;0.25
101;9;6;4;5;2;-3;1;1;1.00
102;6;7;4;5;2;-3;1;4;0.25
103;6;7;4;5;5;0;1;4;0.25
104;6;7;4;5;6;1;1;4;0.25
105;6;7;4;5;7;2;1;4;0.25
106;5;3;5;5;2;-3;1;3;0.33
107;5;3;5;5;4;-1;1;3;0.33
108;5;3;5;5;5;0;1;3;0.33
109;5;4;5;5;2;-3;1;6;0.17
110;5;4;5;5;4;-1;2;6;0.33
111;5;4;5;5;5;0;2;6;0.33
112;5;4;5;5;6;1;1;6;0.17
113;6;4;5;5;2;-3;1;7;0.14
114;6;4;5;5;3;-2;2;7;0.29
115;6;4;5;5;4;-1;1;7;0.14
116;6;4;5;5;5;0;2;7;0.29
117;6;4;5;5;6;1;1;7;0.14
118;7;5;5;5;2;-3;1;5;0.20
119;7;5;5;5;3;-2;1;5;0.20
120;7;5;5;5;6;1;3;5;0.60
121;6;7;5;5;2;-3;1;9;0.11
122;6;7;5;5;3;-2;2;9;0.22
123;6;7;5;5;5;0;2;9;0.22
124;6;7;5;5;6;1;2;9;0.22
125;6;7;5;5;7;2;1;9;0.11
126;6;7;5;5;9;4;1;9;0.11
127;9;4;6;5;2;-3;1;3;0.33
128;9;4;6;5;6;1;1;3;0.33
129;9;4;6;5;7;2;1;3;0.33
130;10;5;6;5;2;-3;1;1;1.00
131;8;6;6;5;2;-3;1;10;0.10
132;8;6;6;5;5;0;3;10;0.30
133;8;6;6;5;6;1;3;10;0.30
134;8;6;6;5;7;2;3;10;0.30
135;8;7;6;5;2;-3;1;2;0.50
136;8;7;6;5;5;0;1;2;0.50
137;6;5;7;5;2;-3;1;7;0.14
138;6;5;7;5;4;-1;2;7;0.29
139;6;5;7;5;6;1;1;7;0.14
140;6;5;7;5;7;2;1;7;0.14
141;6;5;7;5;8;3;1;7;0.14
142;6;5;7;5;9;4;1;7;0.14
143;4;8;7;5;2;-3;1;1;1.00
144;2;6;8;5;2;-3;1;1;1.00
145;6;6;8;5;2;-3;1;6;0.17
146;6;6;8;5;5;0;1;6;0.17
147;6;6;8;5;6;1;1;6;0.17
148;6;6;8;5;7;2;3;6;0.50
149;3;5;9;5;2;-3;1;1;1.00
150;2;5;1;6;2;-4;1;1;1.00
151;4;4;3;6;2;-4;1;5;0.20
152;4;4;3;6;4;-2;2;5;0.40
153;4;4;3;6;5;-1;1;5;0.20
154;4;4;3;6;8;2;1;5;0.20
155;4;5;3;6;2;-4;2;3;0.67
156;4;5;3;6;7;1;1;3;0.33
157;5;5;4;6;2;-4;1;5;0.20
158;5;5;4;6;3;-3;2;5;0.40
159;5;5;4;6;4;-2;1;5;0.20
160;5;5;4;6;6;0;1;5;0.20
161;6;5;4;6;2;-4;1;9;0.11
162;6;5;4;6;4;-2;2;9;0.22
163;6;5;4;6;5;-1;1;9;0.11
164;6;5;4;6;6;0;3;9;0.33
165;6;5;4;6;7;1;2;9;0.22
166;6;6;4;6;2;-4;1;6;0.17
167;6;6;4;6;4;-2;1;6;0.17
168;6;6;4;6;5;-1;2;6;0.33
169;6;6;4;6;6;0;1;6;0.17
170;6;6;4;6;7;1;1;6;0.17
171;5;4;5;6;2;-4;1;5;0.20
172;5;4;5;6;3;-3;1;5;0.20
173;5;4;5;6;4;-2;2;5;0.40
174;5;4;5;6;6;0;1;5;0.20
175;4;7;5;6;2;-4;1;5;0.20
176;4;7;5;6;4;-2;1;5;0.20
177;4;7;5;6;5;-1;2;5;0.40
178;4;7;5;6;8;2;1;5;0.20
179;6;7;5;6;2;-4;1;7;0.14
180;6;7;5;6;5;-1;1;7;0.14
181;6;7;5;6;6;0;3;7;0.43
182;6;7;5;6;7;1;1;7;0.14
183;6;7;5;6;9;3;1;7;0.14
184;9;7;5;6;2;-4;1;1;1.00
185;5;5;6;6;2;-4;1;4;0.25
186;5;5;6;6;3;-3;1;4;0.25
187;5;5;6;6;4;-2;2;4;0.50
188;4;6;6;6;2;-4;1;3;0.33
189;4;6;6;6;4;-2;1;3;0.33
190;4;6;6;6;5;-1;1;3;0.33
191;6;8;6;6;2;-4;1;3;0.33
192;6;8;6;6;5;-1;2;3;0.67
193;7;8;6;6;2;-4;1;5;0.20
194;7;8;6;6;5;-1;1;5;0.20
195;7;8;6;6;6;0;1;5;0.20
196;7;8;6;6;7;1;1;5;0.20
197;7;8;6;6;8;2;1;5;0.20
198;5;5;7;6;2;-4;1;6;0.17
199;5;5;7;6;4;-2;2;6;0.33
200;5;5;7;6;5;-1;1;6;0.17
201;5;5;7;6;6;0;2;6;0.33
202;7;5;7;6;2;-4;1;3;0.33
203;7;5;7;6;5;-1;2;3;0.67
204;1;4;8;6;2;-4;1;1;1.00
205;3;4;8;6;2;-4;1;1;1.00
206;5;5;9;6;2;-4;1;1;1.00
207;3;6;1;7;2;-5;1;1;1.00
208;6;3;2;7;2;-5;1;1;1.00
209;3;6;2;7;2;-5;1;1;1.00
210;6;4;4;7;2;-5;1;1;1.00
211;7;4;4;7;2;-5;1;1;1.00
212;5;5;4;7;2;-5;1;3;0.33
213;5;5;4;7;5;-2;1;3;0.33
214;5;5;4;7;6;-1;1;3;0.33
215;7;5;4;7;2;-5;1;7;0.14
216;7;5;4;7;4;-3;1;7;0.14
217;7;5;4;7;5;-2;2;7;0.29
218;7;5;4;7;6;-1;2;7;0.29
219;7;5;4;7;7;0;1;7;0.14
220;8;5;4;7;2;-5;1;2;0.50
221;8;5;4;7;7;0;1;2;0.50
222;5;7;4;7;2;-5;1;3;0.33
223;5;7;4;7;6;-1;1;3;0.33
224;5;7;4;7;8;1;1;3;0.33
225;5;6;6;7;2;-5;1;3;0.33
226;5;6;6;7;5;-2;1;3;0.33
227;5;6;6;7;6;-1;1;3;0.33
228;7;2;7;7;2;-5;1;1;1.00
229;3;6;7;7;2;-5;1;1;1.00
230;5;7;7;7;2;-5;1;1;1.00
231;5;3;4;8;2;-6;1;1;1.00
232;5;6;5;8;2;-6;1;4;0.25
233;5;6;5;8;6;-2;2;4;0.50
234;5;6;5;8;7;-1;1;4;0.25
235;5;8;5;8;2;-6;1;3;0.33
236;5;8;5;8;3;-5;1;3;0.33
237;5;8;5;8;5;-3;1;3;0.33
238;5;3;6;8;2;-6;1;2;0.50
239;5;3;6;8;6;-2;1;2;0.50
240;3;6;6;8;2;-6;1;3;0.33
241;3;6;6;8;3;-5;1;3;0.33
242;3;6;6;8;5;-3;1;3;0.33
243;6;5;3;9;2;-7;1;1;1.00
244;5;6;4;2;3;1;1;1;1.00
245;6;6;4;2;3;1;1;1;1.00
246;5;4;6;2;3;1;1;2;0.50
247;5;4;6;2;4;2;1;2;0.50
248;4;4;7;2;3;1;1;2;0.50
249;4;4;7;2;5;3;1;2;0.50
250;7;7;7;2;3;1;1;1;1.00
251;7;7;2;3;3;0;1;1;1.00
252;6;4;3;3;3;0;1;1;1.00
253;5;4;4;3;3;0;1;3;0.33
254;5;4;4;3;6;3;2;3;0.67
255;6;5;5;3;3;0;2;6;0.33
256;6;5;5;3;4;1;2;6;0.33
257;6;5;5;3;6;3;1;6;0.17
258;6;5;5;3;8;5;1;6;0.17
259;4;6;5;3;3;0;1;3;0.33
260;4;6;5;3;5;2;2;3;0.67
261;5;6;5;3;3;0;1;3;0.33
262;5;6;5;3;6;3;1;3;0.33
263;5;6;5;3;7;4;1;3;0.33
264;6;8;5;3;3;0;1;2;0.50
265;6;8;5;3;6;3;1;2;0.50
266;5;9;5;3;3;0;1;1;1.00
267;6;5;6;3;3;0;1;4;0.25
268;6;5;6;3;4;1;1;4;0.25
269;6;5;6;3;5;2;1;4;0.25
270;6;5;6;3;6;3;1;4;0.25
271;8;5;6;3;3;0;1;1;1.00
272;4;3;7;3;3;0;1;2;0.50
273;4;3;7;3;6;3;1;2;0.50
274;5;5;8;3;3;0;1;1;1.00
275;5;4;4;4;3;-1;1;1;1.00
276;7;4;4;4;3;-1;1;2;0.50
277;7;4;4;4;6;2;1;2;0.50
278;4;5;4;4;3;-1;1;2;0.50
279;4;5;4;4;6;2;1;2;0.50
280;6;5;4;4;3;-1;2;5;0.40
281;6;5;4;4;4;0;1;5;0.20
282;6;5;4;4;5;1;2;5;0.40
283;5;7;4;4;3;-1;1;2;0.50
284;5;7;4;4;7;3;1;2;0.50
285;5;9;4;4;3;-1;2;2;1.00
286;6;3;5;4;3;-1;1;1;1.00
287;8;4;5;4;3;-1;2;2;1.00
288;5;5;5;4;3;-1;1;7;0.14
289;5;5;5;4;5;1;1;7;0.14
290;5;5;5;4;7;3;2;7;0.29
291;5;5;5;4;8;4;3;7;0.43
292;7;6;5;4;3;-1;1;7;0.14
293;7;6;5;4;5;1;1;7;0.14
294;7;6;5;4;6;2;4;7;0.57
295;7;6;5;4;7;3;1;7;0.14
296;10;6;5;4;3;-1;1;3;0.33
297;10;6;5;4;4;0;1;3;0.33
298;10;6;5;4;6;2;1;3;0.33
299;5;2;6;4;3;-1;1;1;1.00
300;4;4;6;4;3;-1;1;2;0.50
301;4;4;6;4;4;0;1;2;0.50
302;5;4;6;4;3;-1;1;4;0.25
303;5;4;6;4;6;2;1;4;0.25
304;5;4;6;4;7;3;1;4;0.25
305;5;4;6;4;9;5;1;4;0.25
306;7;4;6;4;3;-1;1;2;0.50
307;7;4;6;4;4;0;1;2;0.50
308;4;5;6;4;3;-1;1;4;0.25
309;4;5;6;4;6;2;2;4;0.50
310;4;5;6;4;8;4;1;4;0.25
311;7;6;6;4;3;-1;1;5;0.20
312;7;6;6;4;4;0;1;5;0.20
313;7;6;6;4;6;2;2;5;0.40
314;7;6;6;4;7;3;1;5;0.20
315;4;7;6;4;3;-1;1;5;0.20
316;4;7;6;4;4;0;1;5;0.20
317;4;7;6;4;5;1;1;5;0.20
318;4;7;6;4;6;2;2;5;0.40
319;5;7;6;4;3;-1;1;3;0.33
320;5;7;6;4;5;1;1;3;0.33
321;5;7;6;4;9;5;1;3;0.33
322;6;7;6;4;3;-1;1;2;0.50
323;6;7;6;4;6;2;1;2;0.50
324;5;9;6;4;3;-1;1;2;0.50
325;5;9;6;4;5;1;1;2;0.50
326;6;4;7;4;3;-1;1;2;0.50
327;6;4;7;4;9;5;1;2;0.50
328;5;8;7;4;3;-1;1;2;0.50
329;5;8;7;4;7;3;1;2;0.50
330;3;7;9;4;3;-1;1;1;1.00
331;6;6;2;5;3;-2;1;1;1.00
332;6;3;3;5;3;-2;1;1;1.00
333;5;4;3;5;3;-2;1;3;0.33
334;5;4;3;5;6;1;1;3;0.33
335;5;4;3;5;9;4;1;3;0.33
336;5;4;4;5;3;-2;1;5;0.20
337;5;4;4;5;5;0;2;5;0.40
338;5;4;4;5;6;1;1;5;0.20
339;5;4;4;5;8;3;1;5;0.20
340;7;5;4;5;3;-2;1;4;0.25
341;7;5;4;5;4;-1;1;4;0.25
342;7;5;4;5;6;1;2;4;0.50
343;5;6;4;5;3;-2;1;4;0.25
344;5;6;4;5;5;0;1;4;0.25
345;5;6;4;5;6;1;2;4;0.50
346;6;6;4;5;3;-2;1;8;0.12
347;6;6;4;5;4;-1;2;8;0.25
348;6;6;4;5;5;0;3;8;0.38
349;6;6;4;5;6;1;1;8;0.12
350;6;6;4;5;9;4;1;8;0.12
351;7;3;5;5;3;-2;1;2;0.50
352;7;3;5;5;4;-1;1;2;0.50
353;4;4;5;5;3;-2;1;4;0.25
354;4;4;5;5;6;1;2;4;0.50
355;4;4;5;5;7;2;1;4;0.25
356;4;5;5;5;3;-2;2;6;0.33
357;4;5;5;5;4;-1;2;6;0.33
358;4;5;5;5;6;1;1;6;0.17
359;4;5;5;5;7;2;1;6;0.17
360;5;5;5;5;3;-2;1;3;0.33
361;5;5;5;5;4;-1;1;3;0.33
362;5;5;5;5;6;1;1;3;0.33
363;6;5;5;5;3;-2;1;8;0.12
364;6;5;5;5;4;-1;2;8;0.25
365;6;5;5;5;5;0;1;8;0.12
366;6;5;5;5;6;1;1;8;0.12
367;6;5;5;5;7;2;2;8;0.25
368;6;5;5;5;9;4;1;8;0.12
369;8;5;5;5;3;-2;1;5;0.20
370;8;5;5;5;5;0;1;5;0.20
371;8;5;5;5;6;1;1;5;0.20
372;8;5;5;5;8;3;2;5;0.40
373;5;6;5;5;3;-2;3;13;0.23
374;5;6;5;5;4;-1;3;13;0.23
375;5;6;5;5;5;0;2;13;0.15
376;5;6;5;5;6;1;3;13;0.23
377;5;6;5;5;8;3;2;13;0.15
378;6;6;5;5;3;-2;1;12;0.08
379;6;6;5;5;4;-1;1;12;0.08
380;6;6;5;5;5;0;1;12;0.08
381;6;6;5;5;6;1;4;12;0.33
382;6;6;5;5;7;2;2;12;0.17
383;6;6;5;5;8;3;2;12;0.17
384;6;6;5;5;9;4;1;12;0.08
385;7;6;5;5;3;-2;2;7;0.29
386;7;6;5;5;5;0;3;7;0.43
387;7;6;5;5;6;1;1;7;0.14
388;7;6;5;5;7;2;1;7;0.14
389;5;7;5;5;3;-2;1;3;0.33
390;5;7;5;5;6;1;2;3;0.67
391;5;8;5;5;3;-2;1;4;0.25
392;5;8;5;5;6;1;2;4;0.50
393;5;8;5;5;8;3;1;4;0.25
394;7;8;5;5;3;-2;1;2;0.50
395;7;8;5;5;6;1;1;2;0.50
396;5;3;6;5;3;-2;2;5;0.40
397;5;3;6;5;4;-1;1;5;0.20
398;5;3;6;5;6;1;1;5;0.20
399;5;3;6;5;8;3;1;5;0.20
400;3;4;6;5;3;-2;1;2;0.50
401;3;4;6;5;5;0;1;2;0.50
402;4;4;6;5;3;-2;1;3;0.33
403;4;4;6;5;5;0;2;3;0.67
404;5;4;6;5;3;-2;1;5;0.20
405;5;4;6;5;4;-1;3;5;0.60
406;5;4;6;5;6;1;1;5;0.20
407;5;5;6;5;3;-2;2;12;0.17
408;5;5;6;5;5;0;5;12;0.42
409;5;5;6;5;6;1;2;12;0.17
410;5;5;6;5;7;2;1;12;0.08
411;5;5;6;5;8;3;2;12;0.17
412;8;5;6;5;3;-2;1;7;0.14
413;8;5;6;5;4;-1;1;7;0.14
414;8;5;6;5;5;0;1;7;0.14
415;8;5;6;5;6;1;1;7;0.14
416;8;5;6;5;7;2;2;7;0.29
417;8;5;6;5;9;4;1;7;0.14
418;6;6;6;5;3;-2;1;8;0.12
419;6;6;6;5;4;-1;2;8;0.25
420;6;6;6;5;5;0;3;8;0.38
421;6;6;6;5;6;1;1;8;0.12
422;6;6;6;5;7;2;1;8;0.12
423;7;6;6;5;3;-2;2;6;0.33
424;7;6;6;5;4;-1;1;6;0.17
425;7;6;6;5;5;0;3;6;0.50
426;9;6;6;5;3;-2;1;1;1.00
427;5;7;6;5;3;-2;1;6;0.17
428;5;7;6;5;4;-1;2;6;0.33
429;5;7;6;5;5;0;3;6;0.50
430;6;8;6;5;3;-2;1;2;0.50
431;6;8;6;5;7;2;1;2;0.50
432;5;3;7;5;3;-2;1;3;0.33
433;5;3;7;5;5;0;1;3;0.33
434;5;3;7;5;7;2;1;3;0.33
435;5;4;7;5;3;-2;1;3;0.33
436;5;4;7;5;5;0;1;3;0.33
437;5;4;7;5;6;1;1;3;0.33
438;1;6;7;5;3;-2;1;1;1.00
439;8;6;7;5;3;-2;1;2;0.50
440;8;6;7;5;5;0;1;2;0.50
441;5;7;7;5;3;-2;1;2;0.50
442;5;7;7;5;5;0;1;2;0.50
443;5;6;8;5;3;-2;1;2;0.50
444;5;6;8;5;6;1;1;2;0.50
445;7;6;8;5;3;-2;1;7;0.14
446;7;6;8;5;4;-1;1;7;0.14
447;7;6;8;5;5;0;2;7;0.29
448;7;6;8;5;6;1;3;7;0.43
449;6;5;9;5;3;-2;1;2;0.50
450;6;5;9;5;7;2;1;2;0.50
451;4;7;3;6;3;-3;1;1;1.00
452;6;3;4;6;3;-3;1;1;1.00
453;4;4;4;6;3;-3;1;2;0.50
454;4;4;4;6;6;0;1;2;0.50
455;4;5;4;6;3;-3;1;4;0.25
456;4;5;4;6;5;-1;2;4;0.50
457;4;5;4;6;7;1;1;4;0.25
458;5;6;4;6;3;-3;1;7;0.14
459;5;6;4;6;4;-2;1;7;0.14
460;5;6;4;6;5;-1;2;7;0.29
461;5;6;4;6;6;0;2;7;0.29
462;5;6;4;6;7;1;1;7;0.14
463;8;7;4;6;3;-3;1;1;1.00
464;6;4;5;6;3;-3;1;4;0.25
465;6;4;5;6;4;-2;1;4;0.25
466;6;4;5;6;5;-1;1;4;0.25
467;6;4;5;6;6;0;1;4;0.25
468;2;5;5;6;3;-3;1;1;1.00
469;4;5;5;6;3;-3;2;5;0.40
470;4;5;5;6;4;-2;2;5;0.40
471;4;5;5;6;9;3;1;5;0.20
472;5;5;5;6;3;-3;2;8;0.25
473;5;5;5;6;5;-1;2;8;0.25
474;5;5;5;6;6;0;1;8;0.12
475;5;5;5;6;7;1;3;8;0.38
476;6;5;5;6;3;-3;1;10;0.10
477;6;5;5;6;4;-2;2;10;0.20
478;6;5;5;6;5;-1;5;10;0.50
479;6;5;5;6;7;1;2;10;0.20
480;7;5;5;6;3;-3;1;5;0.20
481;7;5;5;6;4;-2;2;5;0.40
482;7;5;5;6;5;-1;1;5;0.20
483;7;5;5;6;6;0;1;5;0.20
484;3;6;5;6;3;-3;1;4;0.25
485;3;6;5;6;5;-1;2;4;0.50
486;3;6;5;6;8;2;1;4;0.25
487;4;6;5;6;3;-3;1;4;0.25
488;4;6;5;6;4;-2;1;4;0.25
489;4;6;5;6;6;0;2;4;0.50
490;5;6;5;6;3;-3;1;8;0.12
491;5;6;5;6;4;-2;3;8;0.38
492;5;6;5;6;5;-1;2;8;0.25
493;5;6;5;6;7;1;1;8;0.12
494;5;6;5;6;8;2;1;8;0.12
495;6;6;5;6;3;-3;1;7;0.14
496;6;6;5;6;4;-2;1;7;0.14
497;6;6;5;6;5;-1;2;7;0.29
498;6;6;5;6;6;0;2;7;0.29
499;6;6;5;6;7;1;1;7;0.14
500;5;7;5;6;3;-3;1;9;0.11
501;5;7;5;6;4;-2;1;9;0.11
502;5;7;5;6;5;-1;3;9;0.33
503;5;7;5;6;6;0;1;9;0.11
504;5;7;5;6;7;1;2;9;0.22
505;5;7;5;6;10;4;1;9;0.11
506;6;8;5;6;3;-3;1;7;0.14
507;6;8;5;6;4;-2;1;7;0.14
508;6;8;5;6;5;-1;3;7;0.43
509;6;8;5;6;6;0;2;7;0.29
510;5;2;6;6;3;-3;1;2;0.50
511;5;2;6;6;8;2;1;2;0.50
512;4;5;6;6;3;-3;1;3;0.33
513;4;5;6;6;6;0;2;3;0.67
514;5;6;6;6;3;-3;1;8;0.12
515;5;6;6;6;4;-2;3;8;0.38
516;5;6;6;6;5;-1;3;8;0.38
517;5;6;6;6;7;1;1;8;0.12
518;3;7;6;6;3;-3;1;3;0.33
519;3;7;6;6;7;1;1;3;0.33
520;3;7;6;6;8;2;1;3;0.33
521;6;4;7;6;3;-3;1;2;0.50
522;6;4;7;6;5;-1;1;2;0.50
523;4;7;7;6;3;-3;1;4;0.25
524;4;7;7;6;4;-2;1;4;0.25
525;4;7;7;6;7;1;2;4;0.50
526;5;7;7;6;3;-3;1;3;0.33
527;5;7;7;6;4;-2;1;3;0.33
528;5;7;7;6;5;-1;1;3;0.33
529;6;9;7;6;3;-3;1;1;1.00
530;2;2;8;6;3;-3;1;1;1.00
531;5;3;8;6;3;-3;1;1;1.00
532;4;4;8;6;3;-3;1;1;1.00
533;7;5;8;6;3;-3;1;1;1.00
534;7;4;9;6;3;-3;1;1;1.00
535;4;6;9;6;3;-3;1;2;0.50
536;4;6;9;6;9;3;1;2;0.50
537;5;3;2;7;3;-4;1;1;1.00
538;3;4;3;7;3;-4;1;1;1.00
539;6;4;3;7;3;-4;1;1;1.00
540;7;6;3;7;3;-4;1;1;1.00
541;8;8;3;7;3;-4;1;1;1.00
542;6;5;4;7;3;-4;1;4;0.25
543;6;5;4;7;4;-3;1;4;0.25
544;6;5;4;7;6;-1;2;4;0.50
545;6;6;4;7;3;-4;1;3;0.33
546;6;6;4;7;5;-2;1;3;0.33
547;6;6;4;7;6;-1;1;3;0.33
548;7;6;4;7;3;-4;1;1;1.00
549;5;2;5;7;3;-4;1;1;1.00
550;5;3;5;7;3;-4;1;1;1.00
551;5;4;5;7;3;-4;1;2;0.50
552;5;4;5;7;4;-3;1;2;0.50
553;5;6;5;7;3;-4;1;9;0.11
554;5;6;5;7;4;-3;1;9;0.11
555;5;6;5;7;5;-2;3;9;0.33
556;5;6;5;7;6;-1;3;9;0.33
557;5;6;5;7;7;0;1;9;0.11
558;6;6;5;7;3;-4;2;5;0.40
559;6;6;5;7;5;-2;1;5;0.20
560;6;6;5;7;6;-1;1;5;0.20
561;6;6;5;7;7;0;1;5;0.20
562;3;7;5;7;3;-4;1;2;0.50
563;3;7;5;7;6;-1;1;2;0.50
564;8;7;5;7;3;-4;1;1;1.00
565;7;3;6;7;3;-4;1;1;1.00
566;5;5;6;7;3;-4;1;7;0.14
567;5;5;6;7;4;-3;1;7;0.14
568;5;5;6;7;5;-2;2;7;0.29
569;5;5;6;7;6;-1;2;7;0.29
570;5;5;6;7;7;0;1;7;0.14
571;5;2;7;7;3;-4;1;1;1.00
572;5;4;7;7;3;-4;1;3;0.33
573;5;4;7;7;6;-1;2;3;0.67
574;4;6;7;7;3;-4;1;3;0.33
575;4;6;7;7;6;-1;1;3;0.33
576;4;6;7;7;8;1;1;3;0.33
577;3;7;8;7;3;-4;1;1;1.00
578;4;5;2;8;3;-5;1;1;1.00
579;6;4;3;8;3;-5;1;1;1.00
580;7;4;3;8;3;-5;2;2;1.00
581;3;8;3;8;3;-5;1;2;0.50
582;3;8;3;8;6;-2;1;2;0.50
583;7;4;5;8;3;-5;1;2;0.50
584;7;4;5;8;7;-1;1;2;0.50
585;5;5;5;8;3;-5;1;2;0.50
586;5;5;5;8;7;-1;1;2;0.50
587;5;7;5;8;3;-5;1;2;0.50
588;5;7;5;8;7;-1;1;2;0.50
589;6;3;6;8;3;-5;1;2;0.50
590;6;3;6;8;7;-1;1;2;0.50
591;4;6;6;8;3;-5;1;4;0.25
592;4;6;6;8;5;-3;1;4;0.25
593;4;6;6;8;6;-2;2;4;0.50
594;4;6;7;8;3;-5;1;2;0.50
595;4;6;7;8;6;-2;1;2;0.50
596;3;6;8;8;3;-5;1;1;1.00
597;6;6;2;9;3;-6;1;1;1.00
598;4;4;5;9;3;-6;1;1;1.00
599;7;2;7;9;3;-6;1;1;1.00
600;5;3;4;10;3;-7;1;1;1.00
601;5;5;9;1;4;3;1;1;1.00
602;6;6;9;1;4;3;1;1;1.00
603;6;3;4;2;4;2;1;1;1.00
604;4;5;4;2;4;2;1;2;0.50
605;4;5;4;2;9;7;1;2;0.50
606;5;7;4;2;4;2;1;1;1.00
607;7;3;5;2;4;2;1;2;0.50
608;7;3;5;2;6;4;1;2;0.50
609;4;4;5;2;4;2;1;1;1.00
610;3;5;5;2;4;2;1;1;1.00
611;4;5;5;2;4;2;1;2;0.50
612;4;5;5;2;6;4;1;2;0.50
613;5;5;5;2;4;2;1;1;1.00
614;6;8;5;2;4;2;1;2;0.50
615;6;8;5;2;8;6;1;2;0.50
616;5;3;6;2;4;2;1;2;0.50
617;5;3;6;2;8;6;1;2;0.50
618;4;8;6;2;4;2;1;2;0.50
619;4;8;6;2;7;5;1;2;0.50
620;6;7;7;2;4;2;1;1;1.00
621;3;6;8;2;4;2;1;1;1.00
622;5;3;9;2;4;2;1;1;1.00
623;6;4;2;3;4;1;1;2;0.50
624;6;4;2;3;6;3;1;2;0.50
625;5;5;3;3;4;1;1;2;0.50
626;5;5;3;3;5;2;1;2;0.50
627;4;4;4;3;4;1;1;2;0.50
628;4;4;4;3;6;3;1;2;0.50
629;6;5;4;3;4;1;1;2;0.50
630;6;5;4;3;5;2;1;2;0.50
631;2;6;4;3;4;1;1;1;1.00
632;7;9;4;3;4;1;1;1;1.00
633;4;4;5;3;4;1;1;3;0.33
634;4;4;5;3;6;3;2;3;0.67
635;3;5;5;3;4;1;1;1;1.00
636;5;5;5;3;4;1;2;6;0.33
637;5;5;5;3;5;2;1;6;0.17
638;5;5;5;3;6;3;2;6;0.33
639;5;5;5;3;8;5;1;6;0.17
640;7;5;5;3;4;1;1;3;0.33
641;7;5;5;3;5;2;1;3;0.33
642;7;5;5;3;6;3;1;3;0.33
643;3;6;5;3;4;1;1;2;0.50
644;3;6;5;3;6;3;1;2;0.50
645;6;6;5;3;4;1;1;4;0.25
646;6;6;5;3;5;2;2;4;0.50
647;6;6;5;3;6;3;1;4;0.25
648;3;7;5;3;4;1;1;1;1.00
649;5;4;6;3;4;1;1;3;0.33
650;5;4;6;3;6;3;2;3;0.67
651;4;5;6;3;4;1;1;2;0.50
652;4;5;6;3;8;5;1;2;0.50
653;6;4;7;3;4;1;1;2;0.50
654;6;4;7;3;6;3;1;2;0.50
655;6;5;7;3;4;1;1;3;0.33
656;6;5;7;3;5;2;1;3;0.33
657;6;5;7;3;6;3;1;3;0.33
658;7;8;7;3;4;1;1;1;1.00
659;6;6;8;3;4;1;1;2;0.50
660;6;6;8;3;5;2;1;2;0.50
661;4;5;9;3;4;1;1;1;1.00
662;4;6;2;4;4;0;1;1;1.00
663;5;3;3;4;4;0;1;1;1.00
664;9;4;3;4;4;0;1;1;1.00
665;5;5;3;4;4;0;2;7;0.29
666;5;5;3;4;5;1;1;7;0.14
667;5;5;3;4;6;2;1;7;0.14
668;5;5;3;4;7;3;2;7;0.29
669;5;5;3;4;8;4;1;7;0.14
670;6;7;4;4;4;0;2;3;0.67
671;6;7;4;4;6;2;1;3;0.33
672;2;9;4;4;4;0;1;1;1.00
673;10;3;5;4;4;0;1;1;1.00
674;6;4;5;4;4;0;1;6;0.17
675;6;4;5;4;6;2;3;6;0.50
676;6;4;5;4;7;3;1;6;0.17
677;6;4;5;4;8;4;1;6;0.17
678;7;5;5;4;4;0;2;2;1.00
679;6;6;5;4;4;0;3;7;0.43
680;6;6;5;4;5;1;2;7;0.29
681;6;6;5;4;6;2;1;7;0.14
682;6;6;5;4;7;3;1;7;0.14
683;6;7;5;4;4;0;1;5;0.20
684;6;7;5;4;5;1;2;5;0.40
685;6;7;5;4;6;2;1;5;0.20
686;6;7;5;4;7;3;1;5;0.20
687;9;9;5;4;4;0;1;1;1.00
688;6;4;6;4;4;0;1;3;0.33
689;6;4;6;4;5;1;1;3;0.33
690;6;4;6;4;6;2;1;3;0.33
691;5;5;6;4;4;0;1;7;0.14
692;5;5;6;4;5;1;1;7;0.14
693;5;5;6;4;6;2;2;7;0.29
694;5;5;6;4;7;3;1;7;0.14
695;5;5;6;4;8;4;2;7;0.29
696;10;5;6;4;4;0;1;1;1.00
697;8;6;6;4;4;0;1;2;0.50
698;8;6;6;4;5;1;1;2;0.50
699;9;6;6;4;4;0;1;1;1.00
700;3;8;6;4;4;0;1;2;0.50
701;3;8;6;4;7;3;1;2;0.50
702;6;8;6;4;4;0;2;2;1.00
703;3;4;7;4;4;0;1;1;1.00
704;5;5;7;4;4;0;1;6;0.17
705;5;5;7;4;5;1;1;6;0.17
706;5;5;7;4;6;2;1;6;0.17
707;5;5;7;4;7;3;2;6;0.33
708;5;5;7;4;8;4;1;6;0.17
709;4;6;7;4;4;0;2;4;0.50
710;4;6;7;4;7;3;2;4;0.50
711;5;6;7;4;4;0;1;4;0.25
712;5;6;7;4;5;1;1;4;0.25
713;5;6;7;4;6;2;2;4;0.50
714;5;4;8;4;4;0;1;1;1.00
715;8;4;8;4;4;0;1;1;1.00
716;7;6;8;4;4;0;1;1;1.00
717;3;8;8;4;4;0;1;1;1.00
718;6;8;8;4;4;0;1;1;1.00
719;3;2;9;4;4;0;1;1;1.00
720;6;4;9;4;4;0;1;1;1.00
721;4;5;9;4;4;0;1;1;1.00
722;5;5;9;4;4;0;1;1;1.00
723;5;8;2;5;4;-1;1;1;1.00
724;5;3;3;5;4;-1;1;2;0.50
725;5;3;3;5;5;0;1;2;0.50
726;6;5;3;5;4;-1;1;4;0.25
727;6;5;3;5;5;0;2;4;0.50
728;6;5;3;5;6;1;1;4;0.25
729;7;6;3;5;4;-1;1;2;0.50
730;7;6;3;5;5;0;1;2;0.50
731;4;10;3;5;4;-1;1;1;1.00
732;5;3;4;5;4;-1;1;1;1.00
733;7;3;4;5;4;-1;1;1;1.00
734;4;5;4;5;4;-1;1;2;0.50
735;4;5;4;5;5;0;1;2;0.50
736;5;5;4;5;4;-1;3;7;0.43
737;5;5;4;5;5;0;3;7;0.43
738;5;5;4;5;6;1;1;7;0.14
739;3;6;4;5;4;-1;1;4;0.25
740;3;6;4;5;5;0;1;4;0.25
741;3;6;4;5;6;1;1;4;0.25
742;3;6;4;5;7;2;1;4;0.25
743;4;6;4;5;4;-1;1;1;1.00
744;7;6;4;5;4;-1;1;4;0.25
745;7;6;4;5;5;0;2;4;0.50
746;7;6;4;5;7;2;1;4;0.25
747;8;6;4;5;4;-1;1;1;1.00
748;6;8;4;5;4;-1;1;1;1.00
749;9;8;4;5;4;-1;1;1;1.00
750;6;3;5;5;4;-1;1;3;0.33
751;6;3;5;5;5;0;1;3;0.33
752;6;3;5;5;6;1;1;3;0.33
753;3;5;5;5;4;-1;2;3;0.67
754;3;5;5;5;6;1;1;3;0.33
755;3;6;5;5;4;-1;1;1;1.00
756;4;6;5;5;4;-1;1;8;0.12
757;4;6;5;5;5;0;2;8;0.25
758;4;6;5;5;6;1;2;8;0.25
759;4;6;5;5;7;2;1;8;0.12
760;4;6;5;5;8;3;2;8;0.25
761;4;7;5;5;4;-1;2;4;0.50
762;4;7;5;5;7;2;1;4;0.25
763;4;7;5;5;8;3;1;4;0.25
764;4;8;5;5;4;-1;1;3;0.33
765;4;8;5;5;6;1;2;3;0.67
766;8;9;5;5;4;-1;1;1;1.00
767;6;4;6;5;4;-1;1;7;0.14
768;6;4;6;5;5;0;4;7;0.57
769;6;4;6;5;6;1;1;7;0.14
770;6;4;6;5;7;2;1;7;0.14
771;7;4;6;5;4;-1;1;2;0.50
772;7;4;6;5;5;0;1;2;0.50
773;6;5;6;5;4;-1;3;7;0.43
774;6;5;6;5;5;0;2;7;0.29
775;6;5;6;5;6;1;1;7;0.14
776;6;5;6;5;8;3;1;7;0.14
777;7;5;6;5;4;-1;1;7;0.14
778;7;5;6;5;5;0;3;7;0.43
779;7;5;6;5;7;2;3;7;0.43
780;5;6;6;5;4;-1;3;9;0.33
781;5;6;6;5;5;0;1;9;0.11
782;5;6;6;5;6;1;1;9;0.11
783;5;6;6;5;7;2;1;9;0.11
784;5;6;6;5;8;3;2;9;0.22
785;5;6;6;5;9;4;1;9;0.11
786;4;7;6;5;4;-1;1;3;0.33
787;4;7;6;5;6;1;1;3;0.33
788;4;7;6;5;7;2;1;3;0.33
789;6;7;6;5;4;-1;2;5;0.40
790;6;7;6;5;5;0;1;5;0.20
791;6;7;6;5;6;1;2;5;0.40
792;7;7;6;5;4;-1;2;4;0.50
793;7;7;6;5;5;0;2;4;0.50
794;9;8;6;5;4;-1;1;1;1.00
795;6;10;6;5;4;-1;3;3;1.00
796;7;4;7;5;4;-1;1;3;0.33
797;7;4;7;5;5;0;1;3;0.33
798;7;4;7;5;6;1;1;3;0.33
799;4;5;7;5;4;-1;3;5;0.60
800;4;5;7;5;6;1;2;5;0.40
801;5;5;7;5;4;-1;2;6;0.33
802;5;5;7;5;5;0;1;6;0.17
803;5;5;7;5;6;1;2;6;0.33
804;5;5;7;5;7;2;1;6;0.17
805;7;5;7;5;4;-1;1;3;0.33
806;7;5;7;5;6;1;2;3;0.67
807;8;5;7;5;4;-1;2;5;0.40
808;8;5;7;5;5;0;2;5;0.40
809;8;5;7;5;6;1;1;5;0.20
810;3;6;7;5;4;-1;1;3;0.33
811;3;6;7;5;6;1;1;3;0.33
812;3;6;7;5;8;3;1;3;0.33
813;7;6;7;5;4;-1;1;4;0.25
814;7;6;7;5;5;0;1;4;0.25
815;7;6;7;5;6;1;2;4;0.50
816;6;7;7;5;4;-1;1;3;0.33
817;6;7;7;5;5;0;1;3;0.33
818;6;7;7;5;6;1;1;3;0.33
819;7;8;7;5;4;-1;1;1;1.00
820;2;1;8;5;4;-1;1;1;1.00
821;3;6;8;5;4;-1;1;2;0.50
822;3;6;8;5;5;0;1;2;0.50
823;4;9;9;5;4;-1;1;1;1.00
824;6;8;1;6;4;-2;1;1;1.00
825;5;5;2;6;4;-2;1;1;1.00
826;2;7;2;6;4;-2;1;1;1.00
827;4;7;2;6;4;-2;1;2;0.50
828;4;7;2;6;8;2;1;2;0.50
829;8;3;3;6;4;-2;1;1;1.00
830;5;5;3;6;4;-2;1;5;0.20
831;5;5;3;6;5;-1;3;5;0.60
832;5;5;3;6;8;2;1;5;0.20
833;6;5;3;6;4;-2;1;4;0.25
834;6;5;3;6;5;-1;1;4;0.25
835;6;5;3;6;7;1;1;4;0.25
836;6;5;3;6;9;3;1;4;0.25
837;4;6;3;6;4;-2;1;3;0.33
838;4;6;3;6;6;0;1;3;0.33
839;4;6;3;6;8;2;1;3;0.33
840;3;7;3;6;4;-2;1;2;0.50
841;3;7;3;6;5;-1;1;2;0.50
842;5;7;3;6;4;-2;1;2;0.50
843;5;7;3;6;8;2;1;2;0.50
844;6;8;3;6;4;-2;1;1;1.00
845;5;4;4;6;4;-2;1;3;0.33
846;5;4;4;6;5;-1;1;3;0.33
847;5;4;4;6;6;0;1;3;0.33
848;7;4;4;6;4;-2;1;1;1.00
849;7;5;4;6;4;-2;1;4;0.25
850;7;5;4;6;5;-1;2;4;0.50
851;7;5;4;6;6;0;1;4;0.25
852;1;6;4;6;4;-2;1;1;1.00
853;4;7;4;6;4;-2;1;1;1.00
854;6;7;4;6;4;-2;1;2;0.50
855;6;7;4;6;5;-1;1;2;0.50
856;6;9;4;6;4;-2;1;2;0.50
857;6;9;4;6;5;-1;1;2;0.50
858;4;3;5;6;4;-2;1;2;0.50
859;4;3;5;6;6;0;1;2;0.50
860;7;4;5;6;4;-2;1;3;0.33
861;7;4;5;6;5;-1;2;3;0.67
862;8;5;5;6;4;-2;1;7;0.14
863;8;5;5;6;5;-1;2;7;0.29
864;8;5;5;6;6;0;2;7;0.29
865;8;5;5;6;7;1;2;7;0.29
866;6;9;5;6;4;-2;1;1;1.00
867;6;10;5;6;4;-2;1;1;1.00
868;4;4;6;6;4;-2;1;4;0.25
869;4;4;6;6;5;-1;3;4;0.75
870;5;4;6;6;4;-2;2;5;0.40
871;5;4;6;6;6;0;1;5;0.20
872;5;4;6;6;8;2;1;5;0.20
873;5;4;6;6;10;4;1;5;0.20
874;6;4;6;6;4;-2;1;4;0.25
875;6;4;6;6;5;-1;2;4;0.50
876;6;4;6;6;7;1;1;4;0.25
877;8;4;6;6;4;-2;1;2;0.50
878;8;4;6;6;8;2;1;2;0.50
879;6;5;6;6;4;-2;2;10;0.20
880;6;5;6;6;5;-1;2;10;0.20
881;6;5;6;6;6;0;3;10;0.30
882;6;5;6;6;7;1;1;10;0.10
883;6;5;6;6;8;2;2;10;0.20
884;9;5;6;6;4;-2;1;1;1.00
885;7;6;6;6;4;-2;2;4;0.50
886;7;6;6;6;5;-1;1;4;0.25
887;7;6;6;6;6;0;1;4;0.25
888;4;7;6;6;4;-2;1;2;0.50
889;4;7;6;6;6;0;1;2;0.50
890;5;7;6;6;4;-2;4;8;0.50
891;5;7;6;6;5;-1;1;8;0.12
892;5;7;6;6;6;0;2;8;0.25
893;5;7;6;6;7;1;1;8;0.12
894;4;8;6;6;4;-2;1;6;0.17
895;4;8;6;6;5;-1;2;6;0.33
896;4;8;6;6;6;0;2;6;0.33
897;4;8;6;6;9;3;1;6;0.17
898;8;8;6;6;4;-2;1;2;0.50
899;8;8;6;6;5;-1;1;2;0.50
900;6;9;6;6;4;-2;1;1;1.00
901;5;4;7;6;4;-2;4;6;0.67
902;5;4;7;6;5;-1;1;6;0.17
903;5;4;7;6;6;0;1;6;0.17
904;7;4;7;6;4;-2;1;2;0.50
905;7;4;7;6;8;2;1;2;0.50
906;6;5;7;6;4;-2;1;6;0.17
907;6;5;7;6;5;-1;1;6;0.17
908;6;5;7;6;6;0;3;6;0.50
909;6;5;7;6;8;2;1;6;0.17
910;5;6;7;6;4;-2;1;5;0.20
911;5;6;7;6;5;-1;2;5;0.40
912;5;6;7;6;6;0;2;5;0.40
913;6;6;7;6;4;-2;1;6;0.17
914;6;6;7;6;5;-1;2;6;0.33
915;6;6;7;6;6;0;1;6;0.17
916;6;6;7;6;7;1;2;6;0.33
917;2;7;7;6;4;-2;1;1;1.00
918;6;8;7;6;4;-2;1;1;1.00
919;6;3;8;6;4;-2;1;3;0.33
920;6;3;8;6;6;0;1;3;0.33
921;6;3;8;6;8;2;1;3;0.33
922;8;3;8;6;4;-2;1;1;1.00
923;5;4;8;6;4;-2;1;2;0.50
924;5;4;8;6;6;0;1;2;0.50
925;6;6;8;6;4;-2;2;5;0.40
926;6;6;8;6;5;-1;1;5;0.20
927;6;6;8;6;6;0;1;5;0.20
928;6;6;8;6;7;1;1;5;0.20
929;5;7;8;6;4;-2;1;1;1.00
930;4;3;9;6;4;-2;1;1;1.00
931;3;5;9;6;4;-2;1;1;1.00
932;8;5;9;6;4;-2;1;1;1.00
933;4;3;2;7;4;-3;1;1;1.00
934;7;4;2;7;4;-3;1;1;1.00
935;7;5;2;7;4;-3;1;1;1.00
936;5;2;4;7;4;-3;1;2;0.50
937;5;2;4;7;7;0;1;2;0.50
938;6;3;4;7;4;-3;1;1;1.00
939;4;6;4;7;4;-3;1;1;1.00
940;8;6;4;7;4;-3;1;2;0.50
941;8;6;4;7;5;-2;1;2;0.50
942;6;8;4;7;4;-3;1;1;1.00
943;6;9;4;7;4;-3;1;1;1.00
944;7;4;5;7;4;-3;1;2;0.50
945;7;4;5;7;5;-2;1;2;0.50
946;2;5;5;7;4;-3;1;1;1.00
947;4;5;5;7;4;-3;1;2;0.50
948;4;5;5;7;6;-1;1;2;0.50
949;5;5;5;7;4;-3;2;4;0.50
950;5;5;5;7;5;-2;1;4;0.25
951;5;5;5;7;7;0;1;4;0.25
952;7;5;5;7;4;-3;1;4;0.25
953;7;5;5;7;5;-2;1;4;0.25
954;7;5;5;7;6;-1;2;4;0.50
955;8;5;5;7;4;-3;1;2;0.50
956;8;5;5;7;5;-2;1;2;0.50
957;3;6;5;7;4;-3;1;2;0.50
958;3;6;5;7;7;0;1;2;0.50
959;4;6;5;7;4;-3;2;5;0.40
960;4;6;5;7;5;-2;2;5;0.40
961;4;6;5;7;8;1;1;5;0.20
962;5;7;5;7;4;-3;1;2;0.50
963;5;7;5;7;6;-1;1;2;0.50
964;5;9;5;7;4;-3;1;2;0.50
965;5;9;5;7;5;-2;1;2;0.50
966;7;9;5;7;4;-3;1;1;1.00
967;2;4;6;7;4;-3;1;2;0.50
968;2;4;6;7;7;0;1;2;0.50
969;5;4;6;7;4;-3;1;3;0.33
970;5;4;6;7;5;-2;1;3;0.33
971;5;4;6;7;8;1;1;3;0.33
972;6;4;6;7;4;-3;1;4;0.25
973;6;4;6;7;5;-2;2;4;0.50
974;6;4;6;7;7;0;1;4;0.25
975;9;4;6;7;4;-3;1;1;1.00
976;3;5;6;7;4;-3;1;1;1.00
977;6;5;6;7;4;-3;1;4;0.25
978;6;5;6;7;5;-2;1;4;0.25
979;6;5;6;7;7;0;1;4;0.25
980;6;5;6;7;9;2;1;4;0.25
981;7;5;6;7;4;-3;1;6;0.17
982;7;5;6;7;5;-2;3;6;0.50
983;7;5;6;7;6;-1;2;6;0.33
984;6;6;6;7;4;-3;1;2;0.50
985;6;6;6;7;6;-1;1;2;0.50
986;7;7;6;7;4;-3;1;4;0.25
987;7;7;6;7;5;-2;1;4;0.25
988;7;7;6;7;6;-1;1;4;0.25
989;7;7;6;7;7;0;1;4;0.25
990;8;8;6;7;4;-3;1;1;1.00
991;7;4;7;7;4;-3;1;2;0.50
992;7;4;7;7;6;-1;1;2;0.50
993;2;5;7;7;4;-3;1;1;1.00
994;7;7;7;7;4;-3;1;1;1.00
995;5;1;8;7;4;-3;1;1;1.00
996;5;3;8;7;4;-3;1;1;1.00
997;4;5;8;7;4;-3;1;2;0.50
998;4;5;8;7;6;-1;1;2;0.50
999;5;5;8;7;4;-3;1;2;0.50
1000;5;5;8;7;6;-1;1;2;0.50
1001;6;6;8;7;4;-3;1;2;0.50
1002;6;6;8;7;6;-1;1;2;0.50
1003;6;8;2;8;4;-4;1;1;1.00
1004;5;2;4;8;4;-4;1;1;1.00
1005;6;4;4;8;4;-4;1;2;0.50
1006;6;4;4;8;6;-2;1;2;0.50
1007;5;5;4;8;4;-4;1;3;0.33
1008;5;5;4;8;6;-2;1;3;0.33
1009;5;5;4;8;7;-1;1;3;0.33
1010;4;6;4;8;4;-4;1;1;1.00
1011;7;7;4;8;4;-4;1;1;1.00
1012;5;8;4;8;4;-4;1;1;1.00
1013;3;2;5;8;4;-4;1;1;1.00
1014;4;4;5;8;4;-4;1;2;0.50
1015;4;4;5;8;5;-3;1;2;0.50
1016;6;5;5;8;4;-4;1;6;0.17
1017;6;5;5;8;5;-3;3;6;0.50
1018;6;5;5;8;6;-2;1;6;0.17
1019;6;5;5;8;7;-1;1;6;0.17
1020;2;6;5;8;4;-4;1;1;1.00
1021;6;7;5;8;4;-4;1;2;0.50
1022;6;7;5;8;6;-2;1;2;0.50
1023;7;2;6;8;4;-4;1;2;0.50
1024;7;2;6;8;5;-3;1;2;0.50
1025;6;6;6;8;4;-4;1;3;0.33
1026;6;6;6;8;5;-3;1;3;0.33
1027;6;6;6;8;7;-1;1;3;0.33
1028;8;7;6;8;4;-4;1;2;0.50
1029;8;7;6;8;5;-3;1;2;0.50
1030;3;8;6;8;4;-4;1;1;1.00
1031;2;4;7;8;4;-4;1;1;1.00
1032;6;5;7;8;4;-4;1;2;0.50
1033;6;5;7;8;6;-2;1;2;0.50
1034;5;3;8;8;4;-4;1;2;0.50
1035;5;3;8;8;6;-2;1;2;0.50
1036;6;6;8;8;4;-4;1;1;1.00
1037;5;6;9;8;4;-4;1;1;1.00
1038;5;4;1;9;4;-5;1;2;0.50
1039;5;4;1;9;5;-4;1;2;0.50
1040;6;3;2;9;4;-5;1;1;1.00
1041;5;4;2;9;4;-5;1;1;1.00
1042;4;5;2;9;4;-5;1;1;1.00
1043;7;7;2;9;4;-5;1;1;1.00
1044;6;6;3;9;4;-5;1;1;1.00
1045;5;2;4;9;4;-5;2;2;1.00
1046;3;6;4;9;4;-5;1;2;0.50
1047;3;6;4;9;6;-3;1;2;0.50
1048;6;4;5;9;4;-5;1;1;1.00
1049;6;5;5;9;4;-5;1;1;1.00
1050;5;4;6;9;4;-5;1;2;0.50
1051;5;4;6;9;6;-3;1;2;0.50
1052;7;5;6;9;4;-5;1;1;1.00
1053;5;7;6;9;4;-5;1;1;1.00
1054;8;2;7;9;4;-5;1;1;1.00
1055;5;3;7;9;4;-5;1;1;1.00
1056;3;4;9;9;4;-5;1;1;1.00
1057;3;5;5;1;5;4;1;1;1.00
1058;6;6;5;1;5;4;1;1;1.00
1059;6;4;3;2;5;3;1;1;1.00
1060;6;6;3;2;5;3;1;1;1.00
1061;6;5;4;2;5;3;1;1;1.00
1062;7;4;5;2;5;3;1;1;1.00
1063;5;6;5;2;5;3;1;1;1.00
1064;7;6;5;2;5;3;1;1;1.00
1065;5;1;6;2;5;3;1;1;1.00
1066;7;5;6;2;5;3;1;3;0.33
1067;7;5;6;2;7;5;1;3;0.33
1068;7;5;6;2;9;7;1;3;0.33
1069;8;6;6;2;5;3;1;2;0.50
1070;8;6;6;2;6;4;1;2;0.50
1071;5;7;6;2;5;3;1;2;0.50
1072;5;7;6;2;7;5;1;2;0.50
1073;5;4;7;2;5;3;1;3;0.33
1074;5;4;7;2;6;4;2;3;0.67
1075;6;5;8;2;5;3;1;1;1.00
1076;4;6;2;3;5;2;1;1;1.00
1077;4;7;2;3;5;2;1;1;1.00
1078;8;5;3;3;5;2;1;1;1.00
1079;5;6;3;3;5;2;1;2;0.50
1080;5;6;3;3;9;6;1;2;0.50
1081;5;5;4;3;5;2;1;1;1.00
1082;6;6;4;3;5;2;1;1;1.00
1083;7;6;4;3;5;2;1;3;0.33
1084;7;6;4;3;6;3;1;3;0.33
1085;7;6;4;3;7;4;1;3;0.33
1086;9;6;4;3;5;2;1;1;1.00
1087;6;4;5;3;5;2;1;2;0.50
1088;6;4;5;3;8;5;1;2;0.50
1089;7;4;6;3;5;2;1;1;1.00
1090;4;7;6;3;5;2;1;1;1.00
1091;7;7;6;3;5;2;1;2;0.50
1092;7;7;6;3;8;5;1;2;0.50
1093;4;8;6;3;5;2;1;1;1.00
1094;8;3;7;3;5;2;1;1;1.00
1095;5;4;7;3;5;2;1;1;1.00
1096;2;5;7;3;5;2;1;1;1.00
1097;7;5;7;3;5;2;2;2;1.00
1098;3;6;7;3;5;2;1;1;1.00
1099;5;2;8;3;5;2;1;1;1.00
1100;6;2;9;3;5;2;1;1;1.00
1101;3;4;10;3;5;2;1;1;1.00
1102;3;4;2;4;5;1;1;1;1.00
1103;7;4;2;4;5;1;1;1;1.00
1104;3;6;2;4;5;1;1;1;1.00
1105;4;2;3;4;5;1;1;1;1.00
1106;6;4;3;4;5;1;1;2;0.50
1107;6;4;3;4;9;5;1;2;0.50
1108;5;7;3;4;5;1;1;1;1.00
1109;6;8;3;4;5;1;1;1;1.00
1110;4;3;4;4;5;1;1;1;1.00
1111;5;3;4;4;5;1;2;2;1.00
1112;3;5;4;4;5;1;1;1;1.00
1113;5;5;4;4;5;1;1;2;0.50
1114;5;5;4;4;9;5;1;2;0.50
1115;7;5;4;4;5;1;1;2;0.50
1116;7;5;4;4;6;2;1;2;0.50
1117;5;6;4;4;5;1;2;2;1.00
1118;8;6;4;4;5;1;2;3;0.67
1119;8;6;4;4;6;2;1;3;0.33
1120;4;7;4;4;5;1;1;1;1.00
1121;4;8;4;4;5;1;2;2;1.00
1122;4;9;4;4;5;1;1;1;1.00
1123;4;4;5;4;5;1;1;1;1.00
1124;3;5;5;4;5;1;1;3;0.33
1125;3;5;5;4;6;2;1;3;0.33
1126;3;5;5;4;9;5;1;3;0.33
1127;4;5;5;4;5;1;1;3;0.33
1128;4;5;5;4;6;2;2;3;0.67
1129;6;5;5;4;5;1;3;6;0.50
1130;6;5;5;4;6;2;2;6;0.33
1131;6;5;5;4;7;3;1;6;0.17
1132;9;5;5;4;5;1;1;1;1.00
1133;4;6;5;4;5;1;3;5;0.60
1134;4;6;5;4;6;2;1;5;0.20
1135;4;6;5;4;7;3;1;5;0.20
1136;6;8;5;4;5;1;1;2;0.50
1137;6;8;5;4;7;3;1;2;0.50
1138;5;3;6;4;5;1;1;2;0.50
1139;5;3;6;4;8;4;1;2;0.50
1140;6;3;6;4;5;1;1;1;1.00
1141;7;3;6;4;5;1;1;2;0.50
1142;7;3;6;4;9;5;1;2;0.50
1143;3;5;6;4;5;1;1;1;1.00
1144;7;5;6;4;5;1;1;2;0.50
1145;7;5;6;4;6;2;1;2;0.50
1146;4;6;6;4;5;1;3;5;0.60
1147;4;6;6;4;6;2;2;5;0.40
1148;5;6;6;4;5;1;3;5;0.60
1149;5;6;6;4;6;2;1;5;0.20
1150;5;6;6;4;7;3;1;5;0.20
1151;7;7;6;4;5;1;1;3;0.33
1152;7;7;6;4;6;2;1;3;0.33
1153;7;7;6;4;7;3;1;3;0.33
1154;8;7;6;4;5;1;1;1;1.00
1155;7;8;6;4;5;1;1;1;1.00
1156;5;2;7;4;5;1;1;1;1.00
1157;2;4;7;4;5;1;1;1;1.00
1158;6;5;7;4;5;1;1;4;0.25
1159;6;5;7;4;6;2;1;4;0.25
1160;6;5;7;4;7;3;1;4;0.25
1161;6;5;7;4;8;4;1;4;0.25
1162;6;6;7;4;5;1;1;1;1.00
1163;7;6;7;4;5;1;1;1;1.00
1164;8;6;7;4;5;1;1;1;1.00
1165;1;8;7;4;5;1;1;1;1.00
1166;3;8;7;4;5;1;1;1;1.00
1167;2;5;8;4;5;1;1;1;1.00
1168;5;5;8;4;5;1;1;1;1.00
1169;8;6;8;4;5;1;1;1;1.00
1170;6;9;8;4;5;1;1;1;1.00
1171;4;1;9;4;5;1;1;1;1.00
1172;2;4;9;4;5;1;1;2;0.50
1173;2;4;9;4;6;2;1;2;0.50
1174;4;9;9;4;5;1;1;1;1.00
1175;5;4;2;5;5;0;1;1;1.00
1176;4;5;2;5;5;0;1;1;1.00
1177;1;6;2;5;5;0;1;1;1.00
1178;4;7;2;5;5;0;1;2;0.50
1179;4;7;2;5;6;1;1;2;0.50
1180;6;4;3;5;5;0;1;3;0.33
1181;6;4;3;5;6;1;1;3;0.33
1182;6;4;3;5;9;4;1;3;0.33
1183;5;5;3;5;5;0;1;2;0.50
1184;5;5;3;5;6;1;1;2;0.50
1185;5;6;3;5;5;0;1;2;0.50
1186;5;6;3;5;6;1;1;2;0.50
1187;8;6;3;5;5;0;1;1;1.00
1188;3;7;3;5;5;0;1;1;1.00
1189;4;2;4;5;5;0;1;2;0.50
1190;4;2;4;5;7;2;1;2;0.50
1191;3;4;4;5;5;0;2;3;0.67
1192;3;4;4;5;6;1;1;3;0.33
1193;8;5;4;5;5;0;1;1;1.00
1194;8;7;4;5;5;0;1;2;0.50
1195;8;7;4;5;6;1;1;2;0.50
1196;9;9;4;5;5;0;1;1;1.00
1197;7;2;5;5;5;0;1;1;1.00
1198;4;3;5;5;5;0;1;1;1.00
1199;7;4;5;5;5;0;1;2;0.50
1200;7;4;5;5;6;1;1;2;0.50
1201;9;4;5;5;5;0;1;1;1.00
1202;10;5;5;5;5;0;1;1;1.00
1203;2;7;5;5;5;0;1;1;1.00
1204;3;7;5;5;5;0;1;1;1.00
1205;7;7;5;5;5;0;1;3;0.33
1206;7;7;5;5;6;1;1;3;0.33
1207;7;7;5;5;7;2;1;3;0.33
1208;2;8;5;5;5;0;1;2;0.50
1209;2;8;5;5;7;2;1;2;0.50
1210;3;8;5;5;5;0;1;2;0.50
1211;3;8;5;5;6;1;1;2;0.50
1212;6;8;5;5;5;0;2;4;0.50
1213;6;8;5;5;6;1;1;4;0.25
1214;6;8;5;5;7;2;1;4;0.25
1215;8;8;5;5;5;0;1;1;1.00
1216;6;10;5;5;5;0;1;1;1.00
1217;4;3;6;5;5;0;1;2;0.50
1218;4;3;6;5;6;1;1;2;0.50
1219;4;5;6;5;5;0;1;3;0.33
1220;4;5;6;5;6;1;2;3;0.67
1221;9;5;6;5;5;0;1;5;0.20
1222;9;5;6;5;6;1;2;5;0.40
1223;9;5;6;5;7;2;1;5;0.20
1224;9;5;6;5;8;3;1;5;0.20
1225;7;8;6;5;5;0;1;2;0.50
1226;7;8;6;5;6;1;1;2;0.50
1227;4;9;6;5;5;0;1;1;1.00
1228;8;2;7;5;5;0;1;1;1.00
1229;3;4;7;5;5;0;1;1;1.00
1230;6;4;7;5;5;0;1;3;0.33
1231;6;4;7;5;6;1;1;3;0.33
1232;6;4;7;5;7;2;1;3;0.33
1233;4;6;7;5;5;0;2;5;0.40
1234;4;6;7;5;6;1;1;5;0.20
1235;4;6;7;5;7;2;1;5;0.20
1236;4;6;7;5;10;5;1;5;0.20
1237;6;6;7;5;5;0;1;3;0.33
1238;6;6;7;5;6;1;1;3;0.33
1239;6;6;7;5;9;4;1;3;0.33
1240;9;6;7;5;5;0;2;3;0.67
1241;9;6;7;5;7;2;1;3;0.33
1242;7;7;7;5;5;0;1;1;1.00
1243;5;8;7;5;5;0;1;3;0.33
1244;5;8;7;5;6;1;1;3;0.33
1245;5;8;7;5;7;2;1;3;0.33
1246;5;2;8;5;5;0;1;1;1.00
1247;6;2;8;5;5;0;1;2;0.50
1248;6;2;8;5;6;1;1;2;0.50
1249;5;3;8;5;5;0;1;2;0.50
1250;5;3;8;5;7;2;1;2;0.50
1251;6;3;8;5;5;0;1;2;0.50
1252;6;3;8;5;6;1;1;2;0.50
1253;5;4;8;5;5;0;2;2;1.00
1254;6;4;8;5;5;0;1;3;0.33
1255;6;4;8;5;6;1;1;3;0.33
1256;6;4;8;5;7;2;1;3;0.33
1257;5;5;8;5;5;0;2;5;0.40
1258;5;5;8;5;6;1;1;5;0.20
1259;5;5;8;5;8;3;2;5;0.40
1260;6;5;8;5;5;0;1;1;1.00
1261;8;5;8;5;5;0;1;1;1.00
1262;2;7;8;5;5;0;1;2;0.50
1263;2;7;8;5;6;1;1;2;0.50
1264;3;7;8;5;5;0;1;1;1.00
1265;7;8;8;5;5;0;1;2;0.50
1266;7;8;8;5;7;2;1;2;0.50
1267;3;3;9;5;5;0;1;1;1.00
1268;6;4;9;5;5;0;1;1;1.00
1269;7;8;9;5;5;0;1;1;1.00
1270;7;5;10;5;5;0;1;1;1.00
1271;9;6;10;5;5;0;1;1;1.00
1272;5;4;1;6;5;-1;1;1;1.00
1273;7;4;1;6;5;-1;1;1;1.00
1274;7;3;2;6;5;-1;1;2;0.50
1275;7;3;2;6;6;0;1;2;0.50
1276;6;5;2;6;5;-1;1;2;0.50
1277;6;5;2;6;6;0;1;2;0.50
1278;4;2;3;6;5;-1;1;1;1.00
1279;6;4;3;6;5;-1;1;1;1.00
1280;8;5;3;6;5;-1;1;1;1.00
1281;6;6;3;6;5;-1;1;1;1.00
1282;3;8;3;6;5;-1;1;2;0.50
1283;3;8;3;6;8;2;1;2;0.50
1284;5;8;3;6;5;-1;1;2;0.50
1285;5;8;3;6;7;1;1;2;0.50
1286;7;2;4;6;5;-1;1;1;1.00
1287;9;2;4;6;5;-1;1;1;1.00
1288;5;3;4;6;5;-1;2;4;0.50
1289;5;3;4;6;6;0;1;4;0.25
1290;5;3;4;6;7;1;1;4;0.25
1291;6;4;4;6;5;-1;1;3;0.33
1292;6;4;4;6;6;0;1;3;0.33
1293;6;4;4;6;9;3;1;3;0.33
1294;8;4;4;6;5;-1;1;2;0.50
1295;8;4;4;6;7;1;1;2;0.50
1296;4;6;4;6;5;-1;1;2;0.50
1297;4;6;4;6;7;1;1;2;0.50
1298;7;6;4;6;5;-1;1;4;0.25
1299;7;6;4;6;6;0;1;4;0.25
1300;7;6;4;6;7;1;1;4;0.25
1301;7;6;4;6;10;4;1;4;0.25
1302;9;6;4;6;5;-1;1;1;1.00
1303;5;7;4;6;5;-1;1;4;0.25
1304;5;7;4;6;6;0;2;4;0.50
1305;5;7;4;6;7;1;1;4;0.25
1306;2;8;4;6;5;-1;1;1;1.00
1307;4;8;4;6;5;-1;1;2;0.50
1308;4;8;4;6;7;1;1;2;0.50
1309;3;9;4;6;5;-1;1;1;1.00
1310;7;9;4;6;5;-1;1;1;1.00
1311;7;2;5;6;5;-1;1;1;1.00
1312;5;3;5;6;5;-1;1;2;0.50
1313;5;3;5;6;7;1;1;2;0.50
1314;3;5;5;6;5;-1;1;1;1.00
1315;10;5;5;6;5;-1;1;1;1.00
1316;8;6;5;6;5;-1;1;3;0.33
1317;8;6;5;6;6;0;1;3;0.33
1318;8;6;5;6;8;2;1;3;0.33
1319;3;7;5;6;5;-1;1;1;1.00
1320;2;8;5;6;5;-1;1;1;1.00
1321;4;8;5;6;5;-1;1;1;1.00
1322;5;8;5;6;5;-1;1;1;1.00
1323;7;8;5;6;5;-1;1;1;1.00
1324;1;9;5;6;5;-1;1;1;1.00
1325;2;9;5;6;5;-1;1;1;1.00
1326;4;9;5;6;5;-1;1;1;1.00
1327;7;9;5;6;5;-1;1;2;0.50
1328;7;9;5;6;8;2;1;2;0.50
1329;9;9;5;6;5;-1;1;1;1.00
1330;3;10;5;6;5;-1;1;1;1.00
1331;3;2;6;6;5;-1;1;1;1.00
1332;7;4;6;6;5;-1;1;2;0.50
1333;7;4;6;6;8;2;1;2;0.50
1334;3;5;6;6;5;-1;2;5;0.40
1335;3;5;6;6;6;0;1;5;0.20
1336;3;5;6;6;7;1;1;5;0.20
1337;3;5;6;6;8;2;1;5;0.20
1338;7;5;6;6;5;-1;3;4;0.75
1339;7;5;6;6;6;0;1;4;0.25
1340;8;5;6;6;5;-1;2;3;0.67
1341;8;5;6;6;6;0;1;3;0.33
1342;6;6;6;6;5;-1;3;5;0.60
1343;6;6;6;6;6;0;1;5;0.20
1344;6;6;6;6;7;1;1;5;0.20
1345;8;6;6;6;5;-1;1;5;0.20
1346;8;6;6;6;6;0;1;5;0.20
1347;8;6;6;6;8;2;3;5;0.60
1348;6;7;6;6;5;-1;2;4;0.50
1349;6;7;6;6;6;0;1;4;0.25
1350;6;7;6;6;7;1;1;4;0.25
1351;8;7;6;6;5;-1;1;1;1.00
1352;9;7;6;6;5;-1;1;1;1.00
1353;10;7;6;6;5;-1;1;1;1.00
1354;3;8;6;6;5;-1;2;2;1.00
1355;5;8;6;6;5;-1;2;4;0.50
1356;5;8;6;6;6;0;2;4;0.50
1357;3;9;6;6;5;-1;1;1;1.00
1358;6;2;7;6;5;-1;1;2;0.50
1359;6;2;7;6;8;2;1;2;0.50
1360;8;4;7;6;5;-1;1;2;0.50
1361;8;4;7;6;6;0;1;2;0.50
1362;8;5;7;6;5;-1;2;3;0.67
1363;8;5;7;6;6;0;1;3;0.33
1364;7;6;7;6;5;-1;1;4;0.25
1365;7;6;7;6;6;0;1;4;0.25
1366;7;6;7;6;8;2;2;4;0.50
1367;6;7;7;6;5;-1;3;5;0.60
1368;6;7;7;6;6;0;1;5;0.20
1369;6;7;7;6;7;1;1;5;0.20
1370;4;8;7;6;5;-1;1;2;0.50
1371;4;8;7;6;7;1;1;2;0.50
1372;5;8;7;6;5;-1;1;3;0.33
1373;5;8;7;6;6;0;1;3;0.33
1374;5;8;7;6;8;2;1;3;0.33
1375;7;4;8;6;5;-1;1;2;0.50
1376;7;4;8;6;6;0;1;2;0.50
1377;3;6;8;6;5;-1;1;2;0.50
1378;3;6;8;6;7;1;1;2;0.50
1379;6;7;8;6;5;-1;1;1;1.00
1380;9;7;8;6;5;-1;1;1;1.00
1381;6;8;8;6;5;-1;1;1;1.00
1382;6;9;8;6;5;-1;1;1;1.00
1383;6;2;9;6;5;-1;1;1;1.00
1384;4;4;9;6;5;-1;1;1;1.00
1385;7;5;9;6;5;-1;1;1;1.00
1386;5;6;10;6;5;-1;1;1;1.00
1387;6;6;10;6;5;-1;1;1;1.00
1388;8;6;10;6;5;-1;1;1;1.00
1389;4;8;2;7;5;-2;1;1;1.00
1390;5;4;3;7;5;-2;1;2;0.50
1391;5;4;3;7;8;1;1;2;0.50
1392;6;5;3;7;5;-2;1;1;1.00
1393;7;5;3;7;5;-2;2;2;1.00
1394;8;6;3;7;5;-2;1;1;1.00
1395;5;3;4;7;5;-2;1;2;0.50
1396;5;3;4;7;9;2;1;2;0.50
1397;5;6;4;7;5;-2;1;3;0.33
1398;5;6;4;7;6;-1;1;3;0.33
1399;5;6;4;7;7;0;1;3;0.33
1400;6;7;4;7;5;-2;1;2;0.50
1401;6;7;4;7;7;0;1;2;0.50
1402;7;7;4;7;5;-2;1;1;1.00
1403;8;7;4;7;5;-2;1;1;1.00
1404;5;8;4;7;5;-2;1;1;1.00
1405;7;8;4;7;5;-2;1;1;1.00
1406;5;1;5;7;5;-2;1;2;0.50
1407;5;1;5;7;6;-1;1;2;0.50
1408;3;2;5;7;5;-2;1;1;1.00
1409;3;4;5;7;5;-2;1;2;0.50
1410;3;4;5;7;6;-1;1;2;0.50
1411;6;4;5;7;5;-2;2;2;1.00
1412;9;4;5;7;5;-2;1;2;0.50
1413;9;4;5;7;6;-1;1;2;0.50
1414;6;5;5;7;5;-2;3;6;0.50
1415;6;5;5;7;6;-1;3;6;0.50
1416;7;6;5;7;5;-2;1;2;0.50
1417;7;6;5;7;8;1;1;2;0.50
1418;4;7;5;7;5;-2;1;1;1.00
1419;6;7;5;7;5;-2;1;2;0.50
1420;6;7;5;7;6;-1;1;2;0.50
1421;9;7;5;7;5;-2;1;1;1.00
1422;3;8;5;7;5;-2;1;1;1.00
1423;5;8;5;7;5;-2;1;1;1.00
1424;6;8;5;7;5;-2;3;4;0.75
1425;6;8;5;7;6;-1;1;4;0.25
1426;7;1;6;7;5;-2;1;1;1.00
1427;5;3;6;7;5;-2;2;2;1.00
1428;6;3;6;7;5;-2;1;2;0.50
1429;6;3;6;7;9;2;1;2;0.50
1430;3;4;6;7;5;-2;1;1;1.00
1431;7;4;6;7;5;-2;1;2;0.50
1432;7;4;6;7;8;1;1;2;0.50
1433;4;5;6;7;5;-2;1;4;0.25
1434;4;5;6;7;6;-1;1;4;0.25
1435;4;5;6;7;7;0;1;4;0.25
1436;4;5;6;7;9;2;1;4;0.25
1437;8;5;6;7;5;-2;2;2;1.00
1438;3;6;6;7;5;-2;1;2;0.50
1439;3;6;6;7;6;-1;1;2;0.50
1440;7;6;6;7;5;-2;1;4;0.25
1441;7;6;6;7;6;-1;3;4;0.75
1442;6;7;6;7;5;-2;1;4;0.25
1443;6;7;6;7;6;-1;2;4;0.50
1444;6;7;6;7;7;0;1;4;0.25
1445;8;7;6;7;5;-2;1;1;1.00
1446;9;7;6;7;5;-2;1;1;1.00
1447;6;8;6;7;5;-2;1;2;0.50
1448;6;8;6;7;6;-1;1;2;0.50
1449;7;8;6;7;5;-2;1;1;1.00
1450;4;9;6;7;5;-2;1;1;1.00
1451;7;9;6;7;5;-2;2;2;1.00
1452;6;5;7;7;5;-2;2;3;0.67
1453;6;5;7;7;8;1;1;3;0.33
1454;5;6;7;7;5;-2;2;3;0.67
1455;5;6;7;7;7;0;1;3;0.33
1456;7;6;7;7;5;-2;1;3;0.33
1457;7;6;7;7;6;-1;2;3;0.67
1458;4;7;7;7;5;-2;1;1;1.00
1459;3;8;7;7;5;-2;1;1;1.00
1460;4;4;8;7;5;-2;1;1;1.00
1461;6;5;8;7;5;-2;3;3;1.00
1462;7;7;8;7;5;-2;1;2;0.50
1463;7;7;8;7;7;0;1;2;0.50
1464;3;3;9;7;5;-2;1;2;0.50
1465;3;3;9;7;6;-1;1;2;0.50
1466;3;5;9;7;5;-2;1;1;1.00
1467;4;2;1;8;5;-3;1;1;1.00
1468;8;5;2;8;5;-3;1;1;1.00
1469;3;6;2;8;5;-3;1;1;1.00
1470;5;6;2;8;5;-3;1;1;1.00
1471;5;5;3;8;5;-3;2;3;0.67
1472;5;5;3;8;7;-1;1;3;0.33
1473;4;6;3;8;5;-3;1;1;1.00
1474;7;6;3;8;5;-3;1;1;1.00
1475;4;5;4;8;5;-3;2;3;0.67
1476;4;5;4;8;7;-1;1;3;0.33
1477;5;6;4;8;5;-3;2;4;0.50
1478;5;6;4;8;6;-2;2;4;0.50
1479;6;6;4;8;5;-3;1;2;0.50
1480;6;6;4;8;6;-2;1;2;0.50
1481;3;4;5;8;5;-3;1;1;1.00
1482;8;5;5;8;5;-3;1;1;1.00
1483;9;5;5;8;5;-3;1;1;1.00
1484;3;6;5;8;5;-3;1;2;0.50
1485;3;6;5;8;7;-1;1;2;0.50
1486;7;3;6;8;5;-3;1;1;1.00
1487;8;3;6;8;5;-3;1;1;1.00
1488;6;4;6;8;5;-3;1;1;1.00
1489;9;4;6;8;5;-3;1;1;1.00
1490;7;5;6;8;5;-3;1;1;1.00
1491;9;5;6;8;5;-3;1;1;1.00
1492;2;6;6;8;5;-3;2;2;1.00
1493;8;6;6;8;5;-3;1;1;1.00
1494;4;7;6;8;5;-3;1;1;1.00
1495;5;7;6;8;5;-3;1;1;1.00
1496;6;7;6;8;5;-3;2;3;0.67
1497;6;7;6;8;9;1;1;3;0.33
1498;7;7;6;8;5;-3;2;2;1.00
1499;4;8;6;8;5;-3;1;1;1.00
1500;4;9;6;8;5;-3;1;2;0.50
1501;4;9;6;8;6;-2;1;2;0.50
1502;6;2;7;8;5;-3;2;2;1.00
1503;6;3;7;8;5;-3;1;2;0.50
1504;6;3;7;8;7;-1;1;2;0.50
1505;2;5;8;8;5;-3;1;1;1.00
1506;7;6;8;8;5;-3;1;1;1.00
1507;8;7;8;8;5;-3;2;3;0.67
1508;8;7;8;8;7;-1;1;3;0.33
1509;4;7;2;9;5;-4;1;1;1.00
1510;5;3;3;9;5;-4;1;1;1.00
1511;6;4;4;9;5;-4;2;2;1.00
1512;4;6;4;9;5;-4;1;1;1.00
1513;4;3;5;9;5;-4;1;2;0.50
1514;4;3;5;9;7;-2;1;2;0.50
1515;5;6;5;9;5;-4;1;1;1.00
1516;6;6;5;9;5;-4;1;1;1.00
1517;5;7;5;9;5;-4;1;2;0.50
1518;5;7;5;9;6;-3;1;2;0.50
1519;6;7;5;9;5;-4;1;1;1.00
1520;3;7;6;9;5;-4;1;1;1.00
1521;3;4;7;9;5;-4;1;1;1.00
1522;5;6;7;9;5;-4;2;2;1.00
1523;3;7;8;9;5;-4;1;1;1.00
1524;5;2;9;9;5;-4;1;1;1.00
1525;7;4;9;9;5;-4;1;1;1.00
1526;3;5;3;10;5;-5;1;1;1.00
1527;6;7;5;10;5;-5;1;1;1.00
1528;6;4;6;10;5;-5;1;1;1.00
1529;7;9;6;10;5;-5;1;1;1.00
1530;5;5;4;1;6;5;1;1;1.00
1531;5;7;4;1;6;5;1;1;1.00
1532;6;2;5;1;6;5;1;1;1.00
1533;4;9;5;1;6;5;1;1;1.00
1534;6;3;7;1;6;5;1;1;1.00
1535;5;6;8;1;6;5;1;1;1.00
1536;4;4;1;2;6;4;1;1;1.00
1537;3;2;2;2;6;4;1;1;1.00
1538;6;7;3;2;6;4;1;1;1.00
1539;7;7;3;2;6;4;1;1;1.00
1540;6;6;5;2;6;4;2;2;1.00
1541;5;9;6;2;6;4;1;1;1.00
1542;6;1;7;2;6;4;1;1;1.00
1543;6;2;7;2;6;4;1;1;1.00
1544;7;2;3;3;6;3;1;1;1.00
1545;4;4;3;3;6;3;1;1;1.00
1546;3;7;3;3;6;3;1;1;1.00
1547;5;8;3;3;6;3;1;1;1.00
1548;6;3;4;3;6;3;1;2;0.50
1549;6;3;4;3;7;4;1;2;0.50
1550;7;4;4;3;6;3;1;1;1.00
1551;9;4;4;3;6;3;1;2;0.50
1552;9;4;4;3;9;6;1;2;0.50
1553;6;2;5;3;6;3;1;1;1.00
1554;5;4;5;3;6;3;1;1;1.00
1555;4;5;5;3;6;3;1;3;0.33
1556;4;5;5;3;7;4;1;3;0.33
1557;4;5;5;3;8;5;1;3;0.33
1558;7;6;5;3;6;3;1;1;1.00
1559;6;4;6;3;6;3;1;1;1.00
1560;2;6;6;3;6;3;1;1;1.00
1561;2;8;6;3;6;3;1;1;1.00
1562;6;9;6;3;6;3;1;1;1.00
1563;3;2;7;3;6;3;1;1;1.00
1564;6;3;7;3;6;3;1;1;1.00
1565;4;5;7;3;6;3;1;1;1.00
1566;2;7;7;3;6;3;1;1;1.00
1567;4;3;8;3;6;3;2;3;0.67
1568;4;3;8;3;8;5;1;3;0.33
1569;4;5;8;3;6;3;1;1;1.00
1570;8;5;8;3;6;3;1;1;1.00
1571;3;6;8;3;6;3;1;1;1.00
1572;2;7;9;3;6;3;1;1;1.00
1573;4;5;2;4;6;2;1;1;1.00
1574;7;7;2;4;6;2;1;1;1.00
1575;6;8;2;4;6;2;1;1;1.00
1576;3;9;2;4;6;2;1;1;1.00
1577;5;4;3;4;6;2;1;1;1.00
1578;6;5;3;4;6;2;2;2;1.00
1579;7;5;3;4;6;2;1;1;1.00
1580;4;6;3;4;6;2;1;1;1.00
1581;5;9;3;4;6;2;1;1;1.00
1582;3;3;4;4;6;2;1;1;1.00
1583;9;4;4;4;6;2;1;1;1.00
1584;9;5;4;4;6;2;1;1;1.00
1585;4;6;4;4;6;2;1;3;0.33
1586;4;6;4;4;7;3;1;3;0.33
1587;4;6;4;4;9;5;1;3;0.33
1588;6;6;4;4;6;2;1;3;0.33
1589;6;6;4;4;8;4;2;3;0.67
1590;6;8;4;4;6;2;1;1;1.00
1591;8;2;5;4;6;2;1;1;1.00
1592;7;3;5;4;6;2;1;1;1.00
1593;3;6;5;4;6;2;1;1;1.00
1594;4;7;5;4;6;2;1;1;1.00
1595;8;1;6;4;6;2;1;1;1.00
1596;7;2;6;4;6;2;1;2;0.50
1597;7;2;6;4;8;4;1;2;0.50
1598;3;9;6;4;6;2;1;1;1.00
1599;9;4;7;4;6;2;1;1;1.00
1600;7;5;7;4;6;2;1;1;1.00
1601;7;7;7;4;6;2;1;1;1.00
1602;6;8;7;4;6;2;1;1;1.00
1603;8;2;8;4;6;2;1;1;1.00
1604;4;4;8;4;6;2;1;1;1.00
1605;6;4;8;4;6;2;1;1;1.00
1606;7;5;8;4;6;2;1;1;1.00
1607;4;7;8;4;6;2;1;1;1.00
1608;4;2;9;4;6;2;1;1;1.00
1609;6;3;9;4;6;2;1;1;1.00
1610;4;6;9;4;6;2;1;1;1.00
1611;7;6;9;4;6;2;1;1;1.00
1612;2;7;9;4;6;2;1;1;1.00
1613;6;5;2;5;6;1;1;2;0.50
1614;6;5;2;5;7;2;1;2;0.50
1615;7;2;3;5;6;1;1;1;1.00
1616;4;7;3;5;6;1;1;1;1.00
1617;2;9;3;5;6;1;1;1;1.00
1618;8;4;4;5;6;1;1;2;0.50
1619;8;4;4;5;9;4;1;2;0.50
1620;5;7;4;5;6;1;1;2;0.50
1621;5;7;4;5;8;3;1;2;0.50
1622;5;8;4;5;6;1;2;2;1.00
1623;4;2;5;5;6;1;1;1;1.00
1624;5;10;5;5;6;1;1;1;1.00
1625;4;1;6;5;6;1;2;2;1.00
1626;6;3;6;5;6;1;1;1;1.00
1627;7;3;6;5;6;1;1;1;1.00
1628;2;4;6;5;6;1;1;2;0.50
1629;2;4;6;5;7;2;1;2;0.50
1630;2;6;6;5;6;1;1;1;1.00
1631;4;8;6;5;6;1;1;1;1.00
1632;8;8;6;5;6;1;1;1;1.00
1633;2;9;6;5;6;1;1;1;1.00
1634;5;9;6;5;6;1;1;1;1.00
1635;4;3;7;5;6;1;1;1;1.00
1636;8;4;7;5;6;1;2;2;1.00
1637;9;5;7;5;6;1;1;1;1.00
1638;8;7;7;5;6;1;1;1;1.00
1639;3;9;7;5;6;1;1;1;1.00
1640;4;6;8;5;6;1;1;2;0.50
1641;4;6;8;5;9;4;1;2;0.50
1642;9;6;8;5;6;1;1;1;1.00
1643;5;8;8;5;6;1;1;1;1.00
1644;6;8;8;5;6;1;1;1;1.00
1645;4;1;9;5;6;1;1;1;1.00
1646;7;2;9;5;6;1;1;1;1.00
1647;7;5;9;5;6;1;1;2;0.50
1648;7;5;9;5;7;2;1;2;0.50
1649;7;6;9;5;6;1;1;1;1.00
1650;4;7;9;5;6;1;1;1;1.00
1651;6;7;9;5;6;1;1;2;0.50
1652;6;7;9;5;7;2;1;2;0.50
1653;2;9;9;5;6;1;1;1;1.00
1654;5;3;10;5;6;1;1;1;1.00
1655;4;6;10;5;6;1;1;1;1.00
1656;3;5;2;6;6;0;1;1;1.00
1657;6;6;2;6;6;0;1;1;1.00
1658;4;3;3;6;6;0;1;1;1.00
1659;3;4;3;6;6;0;1;1;1.00
1660;2;7;3;6;6;0;1;1;1.00
1661;7;9;3;6;6;0;1;1;1.00
1662;4;3;4;6;6;0;1;1;1.00
1663;9;3;4;6;6;0;1;1;1.00
1664;3;4;4;6;6;0;1;1;1.00
1665;5;8;4;6;6;0;1;1;1.00
1666;7;8;4;6;6;0;1;1;1.00
1667;5;2;5;6;6;0;1;1;1.00
1668;6;3;5;6;6;0;1;1;1.00
1669;7;3;5;6;6;0;2;2;1.00
1670;9;3;5;6;6;0;1;1;1.00
1671;4;4;5;6;6;0;1;3;0.33
1672;4;4;5;6;7;1;2;3;0.67
1673;1;6;5;6;6;0;2;2;1.00
1674;7;6;5;6;6;0;1;3;0.33
1675;7;6;5;6;7;1;2;3;0.67
1676;9;6;5;6;6;0;2;2;1.00
1677;8;8;5;6;6;0;1;2;0.50
1678;8;8;5;6;7;1;1;2;0.50
1679;5;9;5;6;6;0;1;1;1.00
1680;3;4;6;6;6;0;2;3;0.67
1681;3;4;6;6;8;2;1;3;0.33
1682;9;6;6;6;6;0;2;2;1.00
1683;8;9;6;6;6;0;1;1;1.00
1684;9;9;6;6;6;0;1;1;1.00
1685;3;3;7;6;6;0;1;2;0.50
1686;3;3;7;6;9;3;1;2;0.50
1687;6;3;7;6;6;0;1;1;1.00
1688;8;3;7;6;6;0;1;1;1.00
1689;3;5;7;6;6;0;1;1;1.00
1690;4;5;7;6;6;0;1;3;0.33
1691;4;5;7;6;7;1;1;3;0.33
1692;4;5;7;6;9;3;1;3;0.33
1693;4;9;7;6;6;0;1;1;1.00
1694;4;10;7;6;6;0;1;1;1.00
1695;7;3;8;6;6;0;1;1;1.00
1696;6;4;8;6;6;0;3;4;0.75
1697;6;4;8;6;10;4;1;4;0.25
1698;9;4;8;6;6;0;1;1;1.00
1699;5;5;8;6;6;0;1;2;0.50
1700;5;5;8;6;7;1;1;2;0.50
1701;6;5;8;6;6;0;3;3;1.00
1702;5;6;8;6;6;0;1;1;1.00
1703;9;6;8;6;6;0;1;1;1.00
1704;1;7;8;6;6;0;1;1;1.00
1705;2;7;8;6;6;0;1;1;1.00
1706;4;7;8;6;6;0;2;2;1.00
1707;8;7;8;6;6;0;1;1;1.00
1708;3;8;8;6;6;0;1;1;1.00
1709;4;8;8;6;6;0;1;2;0.50
1710;4;8;8;6;7;1;1;2;0.50
1711;8;3;9;6;6;0;1;1;1.00
1712;3;6;9;6;6;0;1;1;1.00
1713;6;8;9;6;6;0;1;1;1.00
1714;5;9;9;6;6;0;1;1;1.00
1715;4;6;2;7;6;-1;1;1;1.00
1716;5;6;2;7;6;-1;1;1;1.00
1717;5;3;3;7;6;-1;2;2;1.00
1718;6;6;3;7;6;-1;1;1;1.00
1719;7;8;3;7;6;-1;1;1;1.00
1720;3;5;4;7;6;-1;1;1;1.00
1721;2;7;4;7;6;-1;1;2;0.50
1722;2;7;4;7;7;0;1;2;0.50
1723;4;8;4;7;6;-1;2;2;1.00
1724;8;3;5;7;6;-1;1;1;1.00
1725;4;4;5;7;6;-1;1;1;1.00
1726;2;6;5;7;6;-1;1;1;1.00
1727;8;6;5;7;6;-1;1;1;1.00
1728;4;8;5;7;6;-1;1;1;1.00
1729;8;8;5;7;6;-1;1;1;1.00
1730;4;4;6;7;6;-1;1;1;1.00
1731;5;7;6;7;6;-1;1;2;0.50
1732;5;7;6;7;7;0;1;2;0.50
1733;5;8;6;7;6;-1;1;1;1.00
1734;6;2;7;7;6;-1;1;1;1.00
1735;6;4;7;7;6;-1;1;1;1.00
1736;3;5;7;7;6;-1;1;1;1.00
1737;4;5;7;7;6;-1;1;1;1.00
1738;5;5;7;7;6;-1;1;2;0.50
1739;5;5;7;7;7;0;1;2;0.50
1740;1;6;7;7;6;-1;1;1;1.00
1741;6;6;7;7;6;-1;1;1;1.00
1742;6;7;7;7;6;-1;1;2;0.50
1743;6;7;7;7;7;0;1;2;0.50
1744;5;8;7;7;6;-1;1;1;1.00
1745;7;8;7;7;6;-1;1;1;1.00
1746;2;4;8;7;6;-1;1;1;1.00
1747;9;4;8;7;6;-1;1;1;1.00
1748;7;5;8;7;6;-1;1;1;1.00
1749;7;8;8;7;6;-1;1;1;1.00
1750;5;4;9;7;6;-1;1;1;1.00
1751;9;6;9;7;6;-1;1;1;1.00
1752;3;4;10;7;6;-1;1;1;1.00
1753;5;2;2;8;6;-2;1;1;1.00
1754;4;5;3;8;6;-2;1;1;1.00
1755;5;6;3;8;6;-2;1;1;1.00
1756;6;6;3;8;6;-2;1;1;1.00
1757;8;6;3;8;6;-2;1;1;1.00
1758;5;7;3;8;6;-2;1;1;1.00
1759;9;1;4;8;6;-2;1;2;0.50
1760;9;1;4;8;8;0;1;2;0.50
1761;7;3;4;8;6;-2;1;1;1.00
1762;3;5;4;8;6;-2;1;1;1.00
1763;2;6;4;8;6;-2;1;1;1.00
1764;5;7;4;8;6;-2;2;2;1.00
1765;6;8;4;8;6;-2;1;1;1.00
1766;2;9;4;8;6;-2;1;2;0.50
1767;2;9;4;8;7;-1;1;2;0.50
1768;7;5;5;8;6;-2;1;1;1.00
1769;6;6;5;8;6;-2;1;2;0.50
1770;6;6;5;8;7;-1;1;2;0.50
1771;3;3;6;8;6;-2;1;1;1.00
1772;5;6;6;8;6;-2;3;3;1.00
1773;7;1;7;8;6;-2;1;1;1.00
1774;5;2;7;8;6;-2;1;1;1.00
1775;7;4;7;8;6;-2;2;2;1.00
1776;4;7;7;8;6;-2;1;1;1.00
1777;6;8;7;8;6;-2;1;2;0.50
1778;6;8;7;8;8;0;1;2;0.50
1779;6;9;7;8;6;-2;1;1;1.00
1780;1;4;8;8;6;-2;1;1;1.00
1781;6;4;8;8;6;-2;1;1;1.00
1782;2;6;8;8;6;-2;1;1;1.00
1783;2;6;9;8;6;-2;1;1;1.00
1784;5;6;2;9;6;-3;1;1;1.00
1785;4;4;3;9;6;-3;1;1;1.00
1786;5;8;3;9;6;-3;1;1;1.00
1787;4;3;4;9;6;-3;1;2;0.50
1788;4;3;4;9;9;0;1;2;0.50
1789;5;4;4;9;6;-3;1;1;1.00
1790;7;6;4;9;6;-3;1;1;1.00
1791;4;7;4;9;6;-3;1;2;0.50
1792;4;7;4;9;9;0;1;2;0.50
1793;8;3;5;9;6;-3;1;1;1.00
1794;7;5;5;9;6;-3;1;1;1.00
1795;6;8;5;9;6;-3;1;1;1.00
1796;5;3;6;9;6;-3;1;1;1.00
1797;4;4;6;9;6;-3;1;1;1.00
1798;6;3;7;9;6;-3;1;1;1.00
1799;3;6;7;9;6;-3;1;1;1.00
1800;6;6;7;9;6;-3;1;1;1.00
1801;7;6;8;9;6;-3;1;1;1.00
1802;5;5;9;9;6;-3;1;1;1.00
1803;7;5;6;10;6;-4;1;1;1.00
1804;4;6;6;10;6;-4;1;1;1.00
1805;4;8;6;10;6;-4;1;1;1.00
1806;3;3;6;1;7;6;1;1;1.00
1807;7;3;7;1;7;6;1;1;1.00
1808;5;4;3;2;7;5;1;1;1.00
1809;5;5;3;2;7;5;1;1;1.00
1810;5;6;3;2;7;5;1;2;0.50
1811;5;6;3;2;9;7;1;2;0.50
1812;4;7;4;2;7;5;1;1;1.00
1813;7;5;5;2;7;5;1;1;1.00
1814;4;6;5;2;7;5;1;1;1.00
1815;5;7;5;2;7;5;1;1;1.00
1816;4;3;6;2;7;5;1;1;1.00
1817;6;4;6;2;7;5;1;1;1.00
1818;5;6;6;2;7;5;1;1;1.00
1819;3;2;7;2;7;5;1;1;1.00
1820;6;6;7;2;7;5;1;1;1.00
1821;3;4;8;2;7;5;1;1;1.00
1822;8;5;8;2;7;5;1;1;1.00
1823;6;5;3;3;7;4;1;2;0.50
1824;6;5;3;3;9;6;1;2;0.50
1825;9;5;3;3;7;4;1;1;1.00
1826;3;5;4;3;7;4;1;1;1.00
1827;4;7;5;3;7;4;1;1;1.00
1828;6;7;5;3;7;4;1;2;0.50
1829;6;7;5;3;8;5;1;2;0.50
1830;4;4;6;3;7;4;1;1;1.00
1831;7;5;6;3;7;4;1;1;1.00
1832;6;6;6;3;7;4;1;1;1.00
1833;9;7;6;3;7;4;1;1;1.00
1834;3;8;6;3;7;4;1;1;1.00
1835;4;9;6;3;7;4;1;1;1.00
1836;4;7;7;3;7;4;1;1;1.00
1837;6;7;8;3;7;4;1;1;1.00
1838;6;8;8;3;7;4;1;1;1.00
1839;3;5;2;4;7;3;1;1;1.00
1840;5;5;2;4;7;3;1;3;0.33
1841;5;5;2;4;9;5;2;3;0.67
1842;8;6;2;4;7;3;1;1;1.00
1843;8;7;3;4;7;3;1;1;1.00
1844;3;3;5;4;7;3;1;1;1.00
1845;8;6;5;4;7;3;1;1;1.00
1846;7;7;5;4;7;3;1;1;1.00
1847;8;7;5;4;7;3;1;1;1.00
1848;1;8;5;4;7;3;1;1;1.00
1849;8;5;6;4;7;3;1;1;1.00
1850;9;5;6;4;7;3;1;1;1.00
1851;4;8;6;4;7;3;1;1;1.00
1852;3;2;7;4;7;3;1;1;1.00
1853;4;2;7;4;7;3;1;1;1.00
1854;5;4;7;4;7;3;1;2;0.50
1855;5;4;7;4;9;5;1;2;0.50
1856;4;7;7;4;7;3;1;1;1.00
1857;2;4;8;4;7;3;1;1;1.00
1858;7;4;8;4;7;3;1;1;1.00
1859;6;5;8;4;7;3;1;1;1.00
1860;6;6;8;4;7;3;1;1;1.00
1861;5;7;8;4;7;3;1;1;1.00
1862;5;6;9;4;7;3;1;1;1.00
1863;5;5;1;5;7;2;1;1;1.00
1864;6;5;1;5;7;2;1;1;1.00
1865;6;3;2;5;7;2;1;1;1.00
1866;6;4;2;5;7;2;1;1;1.00
1867;6;2;3;5;7;2;1;1;1.00
1868;4;5;3;5;7;2;1;1;1.00
1869;2;8;3;5;7;2;1;1;1.00
1870;4;3;4;5;7;2;1;1;1.00
1871;8;3;4;5;7;2;1;1;1.00
1872;7;4;4;5;7;2;1;1;1.00
1873;2;7;4;5;7;2;1;1;1.00
1874;1;9;4;5;7;2;1;1;1.00
1875;4;9;4;5;7;2;1;1;1.00
1876;5;2;5;5;7;2;1;1;1.00
1877;2;4;5;5;7;2;1;1;1.00
1878;2;5;5;5;7;2;1;1;1.00
1879;8;6;5;5;7;2;1;1;1.00
1880;9;6;5;5;7;2;1;1;1.00
1881;8;7;5;5;7;2;1;1;1.00
1882;4;9;5;5;7;2;1;1;1.00
1883;5;2;6;5;7;2;1;1;1.00
1884;2;3;6;5;7;2;1;1;1.00
1885;8;3;6;5;7;2;1;2;0.50
1886;8;3;6;5;8;3;1;2;0.50
1887;8;4;6;5;7;2;2;2;1.00
1888;2;5;6;5;7;2;1;1;1.00
1889;3;5;6;5;7;2;1;1;1.00
1890;2;7;6;5;7;2;1;1;1.00
1891;6;3;7;5;7;2;1;1;1.00
1892;5;9;7;5;7;2;1;1;1.00
1893;4;5;8;5;7;2;1;2;0.50
1894;4;5;8;5;8;3;1;2;0.50
1895;8;6;8;5;7;2;1;1;1.00
1896;9;5;1;6;7;1;1;1;1.00
1897;3;7;1;6;7;1;1;1;1.00
1898;4;1;2;6;7;1;1;1;1.00
1899;8;6;3;6;7;1;1;1;1.00
1900;9;6;3;6;7;1;1;1;1.00
1901;7;7;3;6;7;1;1;1;1.00
1902;5;2;4;6;7;1;1;1;1.00
1903;8;2;4;6;7;1;1;1;1.00
1904;7;7;4;6;7;1;1;1;1.00
1905;4;9;4;6;7;1;1;1;1.00
1906;8;4;5;6;7;1;2;2;1.00
1907;7;7;5;6;7;1;2;2;1.00
1908;8;7;5;6;7;1;1;1;1.00
1909;3;8;5;6;7;1;1;1;1.00
1910;6;3;6;6;7;1;1;1;1.00
1911;7;3;6;6;7;1;1;1;1.00
1912;2;5;6;6;7;1;1;1;1.00
1913;7;7;6;6;7;1;1;1;1.00
1914;1;5;7;6;7;1;1;1;1.00
1915;4;6;7;6;7;1;1;1;1.00
1916;8;6;7;6;7;1;1;2;0.50
1917;8;6;7;6;8;2;1;2;0.50
1918;7;7;7;6;7;1;1;1;1.00
1919;3;9;7;6;7;1;1;1;1.00
1920;7;7;8;6;7;1;1;1;1.00
1921;6;4;9;6;7;1;1;2;0.50
1922;6;4;9;6;8;2;1;2;0.50
1923;3;7;9;6;7;1;1;1;1.00
1924;6;7;9;6;7;1;1;2;0.50
1925;6;7;9;6;10;4;1;2;0.50
1926;5;5;2;7;7;0;1;1;1.00
1927;6;6;2;7;7;0;1;1;1.00
1928;2;7;2;7;7;0;1;1;1.00
1929;7;3;4;7;7;0;1;1;1.00
1930;4;5;4;7;7;0;1;1;1.00
1931;4;2;5;7;7;0;1;1;1.00
1932;2;3;5;7;7;0;1;1;1.00
1933;2;4;5;7;7;0;1;1;1.00
1934;9;5;5;7;7;0;1;1;1.00
1935;5;1;6;7;7;0;1;1;1.00
1936;1;2;6;7;7;0;1;1;1.00
1937;8;3;6;7;7;0;1;1;1.00
1938;8;4;6;7;7;0;1;1;1.00
1939;8;6;6;7;7;0;1;1;1.00
1940;3;4;7;7;7;0;1;1;1.00
1941;2;6;7;7;7;0;1;1;1.00
1942;6;3;8;7;7;0;1;1;1.00
1943;3;5;8;7;7;0;1;1;1.00
1944;7;5;1;8;7;-1;1;1;1.00
1945;3;6;3;8;7;-1;1;1;1.00
1946;4;2;4;8;7;-1;1;1;1.00
1947;2;4;4;8;7;-1;1;1;1.00
1948;6;3;5;8;7;-1;1;1;1.00
1949;2;4;5;8;7;-1;1;1;1.00
1950;7;6;6;8;7;-1;1;1;1.00
1951;5;7;7;8;7;-1;1;1;1.00
1952;6;7;7;8;7;-1;1;1;1.00
1953;3;3;3;9;7;-2;1;1;1.00
1954;6;3;3;9;7;-2;1;1;1.00
1955;5;5;4;9;7;-2;1;1;1.00
1956;3;5;6;9;7;-2;1;1;1.00
1957;6;9;6;9;7;-2;1;1;1.00
1958;6;3;4;10;7;-3;1;1;1.00
1959;6;4;2;1;8;7;1;1;1.00
1960;6;7;5;1;8;7;1;1;1.00
1961;9;5;2;2;8;6;1;1;1.00
1962;6;4;5;2;8;6;1;1;1.00
1963;4;5;6;2;8;6;1;1;1.00
1964;6;6;8;2;8;6;1;1;1.00
1965;5;6;4;3;8;5;1;1;1.00
1966;4;7;4;3;8;5;1;1;1.00
1967;8;7;4;3;8;5;1;1;1.00
1968;3;3;5;3;8;5;1;1;1.00
1969;7;3;6;3;8;5;1;1;1.00
1970;3;4;6;3;8;5;1;1;1.00
1971;7;6;6;3;8;5;1;1;1.00
1972;5;8;6;3;8;5;1;1;1.00
1973;3;5;7;3;8;5;1;1;1.00
1974;8;3;8;3;8;5;1;1;1.00
1975;5;9;1;4;8;4;1;1;1.00
1976;6;9;1;4;8;4;1;1;1.00
1977;5;4;2;4;8;4;1;1;1.00
1978;8;5;2;4;8;4;1;1;1.00
1979;4;7;3;4;8;4;1;1;1.00
1980;6;2;4;4;8;4;1;1;1.00
1981;5;3;5;4;8;4;1;1;1.00
1982;9;4;6;4;8;4;1;1;1.00
1983;5;7;7;4;8;4;1;1;1.00
1984;4;5;8;4;8;4;1;1;1.00
1985;2;6;8;4;8;4;1;1;1.00
1986;5;2;9;4;8;4;1;1;1.00
1987;7;2;9;4;8;4;1;1;1.00
1988;4;3;2;5;8;3;1;1;1.00
1989;7;6;2;5;8;3;1;1;1.00
1990;4;6;3;5;8;3;1;1;1.00
1991;6;2;4;5;8;3;1;1;1.00
1992;2;3;4;5;8;3;1;1;1.00
1993;9;4;4;5;8;3;1;1;1.00
1994;4;7;4;5;8;3;1;1;1.00
1995;3;9;5;5;8;3;1;1;1.00
1996;3;2;6;5;8;3;1;1;1.00
1997;2;5;7;5;8;3;1;1;1.00
1998;9;6;2;6;8;2;1;1;1.00
1999;1;7;2;6;8;2;1;1;1.00
2000;2;3;3;6;8;2;1;1;1.00
2001;2;5;3;6;8;2;1;1;1.00
2002;5;6;3;6;8;2;1;1;1.00
2003;2;6;4;6;8;2;1;1;1.00
2004;2;9;4;6;8;2;1;1;1.00
2005;6;2;6;6;8;2;1;1;1.00
2006;3;3;6;6;8;2;1;1;1.00
2007;4;3;6;6;8;2;1;1;1.00
2008;9;3;6;6;8;2;1;1;1.00
2009;8;7;7;6;8;2;2;2;1.00
2010;8;8;7;6;8;2;1;1;1.00
2011;8;4;8;6;8;2;1;1;1.00
2012;3;4;9;6;8;2;1;1;1.00
2013;3;7;1;7;8;1;1;1;1.00
2014;6;5;2;7;8;1;1;1;1.00
2015;7;6;2;7;8;1;1;1;1.00
2016;8;6;2;7;8;1;1;1;1.00
2017;4;6;3;7;8;1;1;1;1.00
2018;6;2;4;7;8;1;1;1;1.00
2019;4;7;4;7;8;1;1;1;1.00
2020;2;4;7;7;8;1;1;1;1.00
2021;5;4;8;7;8;1;2;2;1.00
2022;3;6;8;7;8;1;1;1;1.00
2023;5;6;8;7;8;1;1;1;1.00
2024;5;6;9;7;8;1;1;1;1.00
2025;3;5;3;8;8;0;1;1;1.00
2026;7;5;3;8;8;0;1;1;1.00
2027;3;6;4;8;8;0;1;1;1.00
2028;6;2;5;8;8;0;1;1;1.00
2029;6;2;6;8;8;0;1;1;1.00
2030;4;3;6;8;8;0;1;1;1.00
2031;2;7;6;8;8;0;1;1;1.00
2032;4;8;7;8;8;0;2;2;1.00
2033;2;2;6;9;8;-1;1;1;1.00
2034;5;5;6;9;8;-1;1;1;1.00
2035;4;5;4;1;9;8;1;1;1.00
2036;7;5;4;1;9;8;1;1;1.00
2037;5;4;5;2;9;7;1;1;1.00
2038;8;7;5;2;9;7;1;1;1.00
2039;6;6;6;2;9;7;1;1;1.00
2040;7;4;7;2;9;7;1;1;1.00
2041;2;7;7;2;9;7;1;1;1.00
2042;4;3;3;3;9;6;1;1;1.00
2043;8;6;5;3;9;6;1;1;1.00
2044;7;5;8;3;9;6;1;1;1.00
2045;4;4;3;4;9;5;1;1;1.00
2046;7;6;4;4;9;5;1;1;1.00
2047;8;3;6;4;9;5;1;1;1.00
2048;6;8;3;5;9;4;1;1;1.00
2049;6;2;5;5;9;4;1;1;1.00
2050;1;5;7;5;9;4;1;1;1.00
2051;2;2;2;6;9;3;1;1;1.00
2052;2;5;4;6;9;3;1;1;1.00
2053;3;5;4;6;9;3;1;1;1.00
2054;2;3;5;6;9;3;1;1;1.00
2055;6;7;2;7;9;2;1;1;1.00
2056;5;8;2;7;9;2;1;1;1.00
2057;5;5;3;7;9;2;1;1;1.00
2058;9;6;3;7;9;2;1;1;1.00
2059;4;6;6;7;9;2;1;1;1.00
2060;4;3;7;8;9;1;1;1;1.00
2061;7;5;2;9;9;0;1;1;1.00
2062;2;5;5;9;9;0;1;1;1.00
2063;4;3;5;3;10;7;1;1;1.00
2064;4;5;3;4;10;6;1;1;1.00
2065;0;6;4;2;1;-1;1;4;0.25
2066;0;6;4;2;3;1;2;4;0.50
2067;0;6;4;2;5;3;1;4;0.25
2068;0;8;4;4;1;-3;1;5;0.20
2069;0;8;4;4;5;1;2;5;0.40
2070;0;8;4;4;6;2;2;5;0.40
2071;0;4;5;4;1;-3;1;18;0.06
2072;0;4;5;4;2;-2;2;18;0.11
2073;0;4;5;4;3;-1;3;18;0.17
2074;0;4;5;4;4;0;2;18;0.11
2075;0;4;5;4;5;1;2;18;0.11
2076;0;4;5;4;6;2;4;18;0.22
2077;0;4;5;4;7;3;1;18;0.06
2078;0;4;5;4;8;4;3;18;0.17
2079;0;5;5;4;1;-3;1;23;0.04
2080;0;5;5;4;3;-1;1;23;0.04
2081;0;5;5;4;4;0;2;23;0.09
2082;0;5;5;4;5;1;7;23;0.30
2083;0;5;5;4;6;2;5;23;0.22
2084;0;5;5;4;7;3;3;23;0.13
2085;0;5;5;4;8;4;3;23;0.13
2086;0;5;5;4;9;5;1;23;0.04
2087;0;7;5;4;1;-3;1;18;0.06
2088;0;7;5;4;4;0;2;18;0.11
2089;0;7;5;4;5;1;4;18;0.22
2090;0;7;5;4;6;2;4;18;0.22
2091;0;7;5;4;7;3;7;18;0.39
2092;0;5;7;4;1;-3;1;15;0.07
2093;0;5;7;4;2;-2;1;15;0.07
2094;0;5;7;4;4;0;2;15;0.13
2095;0;5;7;4;5;1;2;15;0.13
2096;0;5;7;4;6;2;4;15;0.27
2097;0;5;7;4;7;3;3;15;0.20
2098;0;5;7;4;8;4;2;15;0.13
2099;0;6;2;5;1;-4;1;4;0.25
2100;0;6;2;5;3;-2;1;4;0.25
2101;0;6;2;5;5;0;1;4;0.25
2102;0;6;2;5;8;3;1;4;0.25
2103;0;3;5;5;1;-4;1;10;0.10
2104;0;3;5;5;2;-3;1;10;0.10
2105;0;3;5;5;3;-2;1;10;0.10
2106;0;3;5;5;4;-1;3;10;0.30
2107;0;3;5;5;5;0;3;10;0.30
2108;0;3;5;5;6;1;1;10;0.10
2109;0;6;6;5;1;-4;1;41;0.02
2110;0;6;6;5;2;-3;2;41;0.05
2111;0;6;6;5;3;-2;4;41;0.10
2112;0;6;6;5;4;-1;7;41;0.17
2113;0;6;6;5;5;0;12;41;0.29
2114;0;6;6;5;6;1;7;41;0.17
2115;0;6;6;5;7;2;5;41;0.12
2116;0;6;6;5;8;3;2;41;0.05
2117;0;6;6;5;9;4;1;41;0.02
2118;0;6;7;5;1;-4;1;30;0.03
2119;0;6;7;5;3;-2;2;30;0.07
2120;0;6;7;5;4;-1;5;30;0.17
2121;0;6;7;5;5;0;9;30;0.30
2122;0;6;7;5;6;1;7;30;0.23
2123;0;6;7;5;7;2;2;30;0.07
2124;0;6;7;5;8;3;2;30;0.07
2125;0;6;7;5;9;4;1;30;0.03
2126;0;6;7;5;10;5;1;30;0.03
2127;0;4;9;5;1;-4;1;3;0.33
2128;0;4;9;5;5;0;1;3;0.33
2129;0;4;9;5;6;1;1;3;0.33
2130;0;3;3;6;1;-5;1;4;0.25
2131;0;3;3;6;4;-2;1;4;0.25
2132;0;3;3;6;6;0;1;4;0.25
2133;0;3;3;6;8;2;1;4;0.25
2134;0;6;3;7;1;-6;1;7;0.14
2135;0;6;3;7;3;-4;1;7;0.14
2136;0;6;3;7;5;-2;1;7;0.14
2137;0;6;3;7;6;-1;1;7;0.14
2138;0;6;3;7;8;1;2;7;0.29
2139;0;6;3;7;9;2;1;7;0.14
2140;0;7;3;7;1;-6;1;1;1.00
2141;0;5;6;8;1;-7;1;5;0.20
2142;0;5;6;8;5;-3;2;5;0.40
2143;0;5;6;8;6;-2;1;5;0.20
2144;0;5;6;8;7;-1;1;5;0.20
2145;0;5;5;9;1;-8;1;4;0.25
2146;0;5;5;9;4;-5;1;4;0.25
2147;0;5;5;9;6;-3;1;4;0.25
2148;0;5;5;9;9;0;1;4;0.25
2149;0;6;6;9;1;-8;1;1;1.00
2150;0;4;4;1;2;1;1;1;1.00
2151;0;3;2;2;2;0;1;1;1.00
2152;0;5;3;2;2;0;1;2;0.50
2153;0;5;3;2;7;5;1;2;0.50
2154;0;9;5;2;2;0;1;1;1.00
2155;0;5;4;3;2;-1;1;7;0.14
2156;0;5;4;3;4;1;1;7;0.14
2157;0;5;4;3;5;2;3;7;0.43
2158;0;5;4;3;7;4;2;7;0.29
2159;0;6;4;3;2;-1;1;10;0.10
2160;0;6;4;3;3;0;1;10;0.10
2161;0;6;4;3;4;1;2;10;0.20
2162;0;6;4;3;5;2;3;10;0.30
2163;0;6;4;3;6;3;1;10;0.10
2164;0;6;4;3;7;4;1;10;0.10
2165;0;6;4;3;8;5;1;10;0.10
2166;0;5;5;3;2;-1;1;21;0.05
2167;0;5;5;3;3;0;2;21;0.10
2168;0;5;5;3;4;1;7;21;0.33
2169;0;5;5;3;5;2;2;21;0.10
2170;0;5;5;3;6;3;5;21;0.24
2171;0;5;5;3;7;4;1;21;0.05
2172;0;5;5;3;8;5;3;21;0.14
2173;0;7;5;3;2;-1;1;5;0.20
2174;0;7;5;3;4;1;1;5;0.20
2175;0;7;5;3;7;4;2;5;0.40
2176;0;7;5;3;8;5;1;5;0.20
2177;0;5;6;3;2;-1;2;15;0.13
2178;0;5;6;3;3;0;2;15;0.13
2179;0;5;6;3;4;1;5;15;0.33
2180;0;5;6;3;5;2;2;15;0.13
2181;0;5;6;3;6;3;1;15;0.07
2182;0;5;6;3;7;4;2;15;0.13
2183;0;5;6;3;8;5;1;15;0.07
2184;0;6;6;3;2;-1;1;5;0.20
2185;0;6;6;3;6;3;1;5;0.20
2186;0;6;6;3;7;4;1;5;0.20
2187;0;6;6;3;8;5;1;5;0.20
2188;0;6;6;3;9;6;1;5;0.20
2189;0;6;7;3;2;-1;1;2;0.50
2190;0;6;7;3;5;2;1;2;0.50
2191;0;7;7;3;2;-1;1;3;0.33
2192;0;7;7;3;6;3;1;3;0.33
2193;0;7;7;3;7;4;1;3;0.33
2194;0;6;3;4;2;-2;1;6;0.17
2195;0;6;3;4;3;-1;2;6;0.33
2196;0;6;3;4;6;2;1;6;0.17
2197;0;6;3;4;7;3;1;6;0.17
2198;0;6;3;4;10;6;1;6;0.17
2199;0;6;5;4;2;-2;1;29;0.03
2200;0;6;5;4;3;-1;2;29;0.07
2201;0;6;5;4;4;0;5;29;0.17
2202;0;6;5;4;5;1;8;29;0.28
2203;0;6;5;4;6;2;9;29;0.31
2204;0;6;5;4;7;3;4;29;0.14
2205;0;3;6;4;2;-2;2;9;0.22
2206;0;3;6;4;5;1;4;9;0.44
2207;0;3;6;4;8;4;1;9;0.11
2208;0;3;6;4;9;5;2;9;0.22
2209;0;5;6;4;2;-2;1;22;0.05
2210;0;5;6;4;3;-1;1;22;0.05
2211;0;5;6;4;4;0;2;22;0.09
2212;0;5;6;4;5;1;4;22;0.18
2213;0;5;6;4;6;2;7;22;0.32
2214;0;5;6;4;7;3;3;22;0.14
2215;0;5;6;4;8;4;4;22;0.18
2216;0;6;6;4;2;-2;1;24;0.04
2217;0;6;6;4;3;-1;1;24;0.04
2218;0;6;6;4;4;0;3;24;0.12
2219;0;6;6;4;5;1;8;24;0.33
2220;0;6;6;4;6;2;6;24;0.25
2221;0;6;6;4;7;3;3;24;0.12
2222;0;6;6;4;8;4;2;24;0.08
2223;0;4;7;4;2;-2;1;8;0.12
2224;0;4;7;4;3;-1;1;8;0.12
2225;0;4;7;4;4;0;1;8;0.12
2226;0;4;7;4;5;1;1;8;0.12
2227;0;4;7;4;6;2;1;8;0.12
2228;0;4;7;4;7;3;1;8;0.12
2229;0;4;7;4;9;5;2;8;0.25
2230;0;7;3;5;2;-3;2;7;0.29
2231;0;7;3;5;4;-1;1;7;0.14
2232;0;7;3;5;5;0;2;7;0.29
2233;0;7;3;5;6;1;2;7;0.29
2234;0;4;4;5;2;-3;1;16;0.06
2235;0;4;4;5;3;-2;3;16;0.19
2236;0;4;4;5;4;-1;1;16;0.06
2237;0;4;4;5;5;0;4;16;0.25
2238;0;4;4;5;6;1;3;16;0.19
2239;0;4;4;5;7;2;1;16;0.06
2240;0;4;4;5;8;3;2;16;0.12
2241;0;4;4;5;9;4;1;16;0.06
2242;0;5;4;5;2;-3;1;22;0.05
2243;0;5;4;5;3;-2;1;22;0.05
2244;0;5;4;5;4;-1;7;22;0.32
2245;0;5;4;5;5;0;6;22;0.27
2246;0;5;4;5;6;1;5;22;0.23
2247;0;5;4;5;7;2;2;22;0.09
2248;0;6;4;5;2;-3;1;23;0.04
2249;0;6;4;5;3;-2;2;23;0.09
2250;0;6;4;5;4;-1;6;23;0.26
2251;0;6;4;5;5;0;7;23;0.30
2252;0;6;4;5;6;1;4;23;0.17
2253;0;6;4;5;7;2;2;23;0.09
2254;0;6;4;5;9;4;1;23;0.04
2255;0;7;4;5;2;-3;1;10;0.10
2256;0;7;4;5;5;0;2;10;0.20
2257;0;7;4;5;6;1;3;10;0.30
2258;0;7;4;5;7;2;2;10;0.20
2259;0;7;4;5;8;3;2;10;0.20
2260;0;4;5;5;2;-3;2;21;0.10
2261;0;4;5;5;3;-2;3;21;0.14
2262;0;4;5;5;4;-1;3;21;0.14
2263;0;4;5;5;5;0;6;21;0.29
2264;0;4;5;5;6;1;5;21;0.24
2265;0;4;5;5;7;2;2;21;0.10
2266;0;5;5;5;2;-3;1;32;0.03
2267;0;5;5;5;3;-2;6;32;0.19
2268;0;5;5;5;4;-1;7;32;0.22
2269;0;5;5;5;5;0;3;32;0.09
2270;0;5;5;5;6;1;8;32;0.25
2271;0;5;5;5;7;2;4;32;0.12
2272;0;5;5;5;8;3;2;32;0.06
2273;0;5;5;5;9;4;1;32;0.03
2274;0;7;5;5;2;-3;1;22;0.05
2275;0;7;5;5;3;-2;3;22;0.14
2276;0;7;5;5;4;-1;2;22;0.09
2277;0;7;5;5;5;0;5;22;0.23
2278;0;7;5;5;6;1;5;22;0.23
2279;0;7;5;5;7;2;4;22;0.18
2280;0;7;5;5;8;3;1;22;0.05
2281;0;7;5;5;9;4;1;22;0.05
2282;0;4;6;5;2;-3;1;26;0.04
2283;0;4;6;5;3;-2;3;26;0.12
2284;0;4;6;5;4;-1;5;26;0.19
2285;0;4;6;5;5;0;8;26;0.31
2286;0;4;6;5;6;1;4;26;0.15
2287;0;4;6;5;7;2;5;26;0.19
2288;0;5;6;5;2;-3;1;44;0.02
2289;0;5;6;5;3;-2;3;44;0.07
2290;0;5;6;5;4;-1;5;44;0.11
2291;0;5;6;5;5;0;13;44;0.30
2292;0;5;6;5;6;1;8;44;0.18
2293;0;5;6;5;7;2;9;44;0.20
2294;0;5;6;5;8;3;4;44;0.09
2295;0;5;6;5;9;4;1;44;0.02
2296;0;7;6;5;2;-3;1;21;0.05
2297;0;7;6;5;3;-2;1;21;0.05
2298;0;7;6;5;4;-1;7;21;0.33
2299;0;7;6;5;5;0;7;21;0.33
2300;0;7;6;5;6;1;3;21;0.14
2301;0;7;6;5;7;2;2;21;0.10
2302;0;5;7;5;2;-3;1;29;0.03
2303;0;5;7;5;4;-1;10;29;0.34
2304;0;5;7;5;5;0;3;29;0.10
2305;0;5;7;5;6;1;9;29;0.31
2306;0;5;7;5;7;2;2;29;0.07
2307;0;5;7;5;8;3;2;29;0.07
2308;0;5;7;5;9;4;2;29;0.07
2309;0;8;7;5;2;-3;1;5;0.20
2310;0;8;7;5;4;-1;1;5;0.20
2311;0;8;7;5;5;0;1;5;0.20
2312;0;8;7;5;6;1;1;5;0.20
2313;0;8;7;5;7;2;1;5;0.20
2314;0;6;8;5;2;-3;2;22;0.09
2315;0;6;8;5;3;-2;2;22;0.09
2316;0;6;8;5;4;-1;2;22;0.09
2317;0;6;8;5;5;0;4;22;0.18
2318;0;6;8;5;6;1;7;22;0.32
2319;0;6;8;5;7;2;4;22;0.18
2320;0;6;8;5;9;4;1;22;0.05
2321;0;5;9;5;2;-3;1;5;0.20
2322;0;5;9;5;3;-2;1;5;0.20
2323;0;5;9;5;6;1;1;5;0.20
2324;0;5;9;5;7;2;2;5;0.40
2325;0;5;1;6;2;-4;1;2;0.50
2326;0;5;1;6;7;1;1;2;0.50
2327;0;4;3;6;2;-4;1;7;0.14
2328;0;4;3;6;4;-2;2;7;0.29
2329;0;4;3;6;5;-1;2;7;0.29
2330;0;4;3;6;6;0;1;7;0.14
2331;0;4;3;6;8;2;1;7;0.14
2332;0;5;3;6;2;-4;2;14;0.14
2333;0;5;3;6;4;-2;2;14;0.14
2334;0;5;3;6;5;-1;5;14;0.36
2335;0;5;3;6;7;1;2;14;0.14
2336;0;5;3;6;8;2;2;14;0.14
2337;0;5;3;6;9;3;1;14;0.07
2338;0;5;4;6;2;-4;2;24;0.08
2339;0;5;4;6;3;-3;3;24;0.12
2340;0;5;4;6;4;-2;4;24;0.17
2341;0;5;4;6;5;-1;5;24;0.21
2342;0;5;4;6;6;0;5;24;0.21
2343;0;5;4;6;7;1;3;24;0.12
2344;0;5;4;6;9;3;2;24;0.08
2345;0;6;4;6;2;-4;1;22;0.05
2346;0;6;4;6;3;-3;1;22;0.05
2347;0;6;4;6;4;-2;3;22;0.14
2348;0;6;4;6;5;-1;7;22;0.32
2349;0;6;4;6;6;0;4;22;0.18
2350;0;6;4;6;7;1;4;22;0.18
2351;0;6;4;6;8;2;1;22;0.05
2352;0;6;4;6;10;4;1;22;0.05
2353;0;4;5;6;2;-4;1;17;0.06
2354;0;4;5;6;3;-3;2;17;0.12
2355;0;4;5;6;4;-2;4;17;0.24
2356;0;4;5;6;5;-1;3;17;0.18
2357;0;4;5;6;6;0;3;17;0.18
2358;0;4;5;6;7;1;4;17;0.24
2359;0;7;5;6;2;-4;3;26;0.12
2360;0;7;5;6;3;-3;1;26;0.04
2361;0;7;5;6;4;-2;2;26;0.08
2362;0;7;5;6;5;-1;7;26;0.27
2363;0;7;5;6;6;0;4;26;0.15
2364;0;7;5;6;7;1;6;26;0.23
2365;0;7;5;6;8;2;1;26;0.04
2366;0;7;5;6;9;3;1;26;0.04
2367;0;7;5;6;10;4;1;26;0.04
2368;0;5;6;6;2;-4;1;31;0.03
2369;0;5;6;6;3;-3;2;31;0.06
2370;0;5;6;6;4;-2;5;31;0.16
2371;0;5;6;6;5;-1;9;31;0.29
2372;0;5;6;6;6;0;8;31;0.26
2373;0;5;6;6;7;1;3;31;0.10
2374;0;5;6;6;8;2;3;31;0.10
2375;0;6;6;6;2;-4;1;27;0.04
2376;0;6;6;6;3;-3;1;27;0.04
2377;0;6;6;6;4;-2;6;27;0.22
2378;0;6;6;6;5;-1;9;27;0.33
2379;0;6;6;6;6;0;5;27;0.19
2380;0;6;6;6;7;1;2;27;0.07
2381;0;6;6;6;8;2;3;27;0.11
2382;0;8;6;6;2;-4;2;22;0.09
2383;0;8;6;6;4;-2;2;22;0.09
2384;0;8;6;6;5;-1;10;22;0.45
2385;0;8;6;6;6;0;5;22;0.23
2386;0;8;6;6;7;1;1;22;0.05
2387;0;8;6;6;8;2;1;22;0.05
2388;0;8;6;6;9;3;1;22;0.05
2389;0;5;7;6;2;-4;2;23;0.09
2390;0;5;7;6;4;-2;3;23;0.13
2391;0;5;7;6;5;-1;6;23;0.26
2392;0;5;7;6;6;0;8;23;0.35
2393;0;5;7;6;7;1;2;23;0.09
2394;0;5;7;6;8;2;1;23;0.04
2395;0;5;7;6;9;3;1;23;0.04
2396;0;4;8;6;2;-4;2;13;0.15
2397;0;4;8;6;3;-3;1;13;0.08
2398;0;4;8;6;4;-2;1;13;0.08
2399;0;4;8;6;5;-1;1;13;0.08
2400;0;4;8;6;6;0;6;13;0.46
2401;0;4;8;6;8;2;1;13;0.08
2402;0;4;8;6;10;4;1;13;0.08
2403;0;5;9;6;2;-4;1;4;0.25
2404;0;5;9;6;4;-2;2;4;0.50
2405;0;5;9;6;5;-1;1;4;0.25
2406;0;6;1;7;2;-5;1;1;1.00
2407;0;3;2;7;2;-5;1;3;0.33
2408;0;3;2;7;3;-4;1;3;0.33
2409;0;3;2;7;4;-3;1;3;0.33
2410;0;6;2;7;2;-5;1;6;0.17
2411;0;6;2;7;6;-1;2;6;0.33
2412;0;6;2;7;7;0;1;6;0.17
2413;0;6;2;7;8;1;2;6;0.33
2414;0;4;4;7;2;-5;2;2;1.00
2415;0;5;4;7;2;-5;3;18;0.17
2416;0;5;4;7;3;-4;1;18;0.06
2417;0;5;4;7;4;-3;2;18;0.11
2418;0;5;4;7;5;-2;3;18;0.17
2419;0;5;4;7;6;-1;6;18;0.33
2420;0;5;4;7;7;0;3;18;0.17
2421;0;7;4;7;2;-5;1;10;0.10
2422;0;7;4;7;5;-2;3;10;0.30
2423;0;7;4;7;6;-1;2;10;0.20
2424;0;7;4;7;7;0;2;10;0.20
2425;0;7;4;7;8;1;2;10;0.20
2426;0;6;6;7;2;-5;1;13;0.08
2427;0;6;6;7;4;-3;1;13;0.08
2428;0;6;6;7;5;-2;3;13;0.23
2429;0;6;6;7;6;-1;6;13;0.46
2430;0;6;6;7;7;0;1;13;0.08
2431;0;6;6;7;9;2;1;13;0.08
2432;0;2;7;7;2;-5;1;3;0.33
2433;0;2;7;7;3;-4;1;3;0.33
2434;0;2;7;7;6;-1;1;3;0.33
2435;0;6;7;7;2;-5;1;13;0.08
2436;0;6;7;7;3;-4;1;13;0.08
2437;0;6;7;7;5;-2;3;13;0.23
2438;0;6;7;7;6;-1;5;13;0.38
2439;0;6;7;7;7;0;2;13;0.15
2440;0;6;7;7;8;1;1;13;0.08
2441;0;7;7;7;2;-5;1;5;0.20
2442;0;7;7;7;4;-3;1;5;0.20
2443;0;7;7;7;5;-2;1;5;0.20
2444;0;7;7;7;6;-1;1;5;0.20
2445;0;7;7;7;7;0;1;5;0.20
2446;0;3;4;8;2;-6;1;2;0.50
2447;0;3;4;8;6;-2;1;2;0.50
2448;0;6;5;8;2;-6;1;9;0.11
2449;0;6;5;8;4;-4;1;9;0.11
2450;0;6;5;8;5;-3;1;9;0.11
2451;0;6;5;8;6;-2;3;9;0.33
2452;0;6;5;8;7;-1;3;9;0.33
2453;0;8;5;8;2;-6;1;3;0.33
2454;0;8;5;8;3;-5;1;3;0.33
2455;0;8;5;8;5;-3;1;3;0.33
2456;0;3;6;8;2;-6;1;8;0.12
2457;0;3;6;8;3;-5;1;8;0.12
2458;0;3;6;8;5;-3;2;8;0.25
2459;0;3;6;8;6;-2;2;8;0.25
2460;0;3;6;8;7;-1;1;8;0.12
2461;0;3;6;8;8;0;1;8;0.12
2462;0;6;6;8;2;-6;1;18;0.06
2463;0;6;6;8;3;-5;2;18;0.11
2464;0;6;6;8;4;-4;1;18;0.06
2465;0;6;6;8;5;-3;6;18;0.33
2466;0;6;6;8;6;-2;5;18;0.28
2467;0;6;6;8;7;-1;2;18;0.11
2468;0;6;6;8;8;0;1;18;0.06
2469;0;5;3;9;2;-7;1;1;1.00
2470;0;4;6;2;3;1;1;3;0.33
2471;0;4;6;2;4;2;1;3;0.33
2472;0;4;6;2;7;5;1;3;0.33
2473;0;4;7;2;3;1;1;6;0.17
2474;0;4;7;2;5;3;2;6;0.33
2475;0;4;7;2;6;4;2;6;0.33
2476;0;4;7;2;9;7;1;6;0.17
2477;0;7;7;2;3;1;1;3;0.33
2478;0;7;7;2;4;2;1;3;0.33
2479;0;7;7;2;9;7;1;3;0.33
2480;0;7;2;3;3;0;1;2;0.50
2481;0;7;2;3;5;2;1;2;0.50
2482;0;4;3;3;3;0;1;2;0.50
2483;0;4;3;3;6;3;1;2;0.50
2484;0;4;4;3;3;0;1;8;0.12
2485;0;4;4;3;4;1;1;8;0.12
2486;0;4;4;3;6;3;5;8;0.62
2487;0;4;4;3;9;6;1;8;0.12
2488;0;6;5;3;3;0;2;14;0.14
2489;0;6;5;3;4;1;2;14;0.14
2490;0;6;5;3;5;2;4;14;0.29
2491;0;6;5;3;6;3;4;14;0.29
2492;0;6;5;3;7;4;1;14;0.07
2493;0;6;5;3;9;6;1;14;0.07
2494;0;8;5;3;3;0;1;2;0.50
2495;0;8;5;3;6;3;1;2;0.50
2496;0;9;5;3;3;0;1;1;1.00
2497;0;3;7;3;3;0;1;4;0.25
2498;0;3;7;3;5;2;1;4;0.25
2499;0;3;7;3;6;3;2;4;0.50
2500;0;5;8;3;3;0;1;4;0.25
2501;0;5;8;3;6;3;2;4;0.50
2502;0;5;8;3;9;6;1;4;0.25
2503;0;4;4;4;3;-1;2;4;0.50
2504;0;4;4;4;6;2;2;4;0.50
2505;0;5;4;4;3;-1;3;13;0.23
2506;0;5;4;4;4;0;1;13;0.08
2507;0;5;4;4;5;1;5;13;0.38
2508;0;5;4;4;6;2;3;13;0.23
2509;0;5;4;4;9;5;1;13;0.08
2510;0;7;4;4;3;-1;1;6;0.17
2511;0;7;4;4;4;0;2;6;0.33
2512;0;7;4;4;5;1;1;6;0.17
2513;0;7;4;4;6;2;1;6;0.17
2514;0;7;4;4;7;3;1;6;0.17
2515;0;9;4;4;3;-1;2;4;0.50
2516;0;9;4;4;4;0;1;4;0.25
2517;0;9;4;4;5;1;1;4;0.25
2518;0;3;5;4;3;-1;1;5;0.20
2519;0;3;5;4;4;0;1;5;0.20
2520;0;3;5;4;6;2;1;5;0.20
2521;0;3;5;4;7;3;1;5;0.20
2522;0;3;5;4;8;4;1;5;0.20
2523;0;2;6;4;3;-1;1;3;0.33
2524;0;2;6;4;6;2;1;3;0.33
2525;0;2;6;4;8;4;1;3;0.33
2526;0;4;6;4;3;-1;3;12;0.25
2527;0;4;6;4;4;0;3;12;0.25
2528;0;4;6;4;5;1;1;12;0.08
2529;0;4;6;4;6;2;2;12;0.17
2530;0;4;6;4;7;3;1;12;0.08
2531;0;4;6;4;8;4;1;12;0.08
2532;0;4;6;4;9;5;1;12;0.08
2533;0;7;6;4;3;-1;3;14;0.21
2534;0;7;6;4;4;0;1;14;0.07
2535;0;7;6;4;5;1;4;14;0.29
2536;0;7;6;4;6;2;4;14;0.29
2537;0;7;6;4;7;3;1;14;0.07
2538;0;7;6;4;9;5;1;14;0.07
2539;0;9;6;4;3;-1;1;3;0.33
2540;0;9;6;4;5;1;1;3;0.33
2541;0;9;6;4;6;2;1;3;0.33
2542;0;8;7;4;3;-1;1;5;0.20
2543;0;8;7;4;5;1;2;5;0.40
2544;0;8;7;4;6;2;1;5;0.20
2545;0;8;7;4;7;3;1;5;0.20
2546;0;7;9;4;3;-1;1;2;0.50
2547;0;7;9;4;6;2;1;2;0.50
2548;0;3;3;5;3;-2;1;3;0.33
2549;0;3;3;5;4;-1;1;3;0.33
2550;0;3;3;5;5;0;1;3;0.33
2551;0;4;3;5;3;-2;1;6;0.17
2552;0;4;3;5;5;0;1;6;0.17
2553;0;4;3;5;6;1;2;6;0.33
2554;0;4;3;5;9;4;2;6;0.33
2555;0;6;5;5;3;-2;6;43;0.14
2556;0;6;5;5;4;-1;6;43;0.14
2557;0;6;5;5;5;0;8;43;0.19
2558;0;6;5;5;6;1;10;43;0.23
2559;0;6;5;5;7;2;6;43;0.14
2560;0;6;5;5;8;3;6;43;0.14
2561;0;6;5;5;9;4;1;43;0.02
2562;0;8;5;5;3;-2;2;18;0.11
2563;0;8;5;5;4;-1;1;18;0.06
2564;0;8;5;5;5;0;5;18;0.28
2565;0;8;5;5;6;1;7;18;0.39
2566;0;8;5;5;7;2;2;18;0.11
2567;0;8;5;5;8;3;1;18;0.06
2568;0;3;6;5;3;-2;2;12;0.17
2569;0;3;6;5;4;-1;1;12;0.08
2570;0;3;6;5;5;0;1;12;0.08
2571;0;3;6;5;6;1;4;12;0.33
2572;0;3;6;5;7;2;2;12;0.17
2573;0;3;6;5;8;3;2;12;0.17
2574;0;8;6;5;3;-2;1;7;0.14
2575;0;8;6;5;4;-1;1;7;0.14
2576;0;8;6;5;5;0;1;7;0.14
2577;0;8;6;5;6;1;3;7;0.43
2578;0;8;6;5;7;2;1;7;0.14
2579;0;3;7;5;3;-2;1;5;0.20
2580;0;3;7;5;5;0;1;5;0.20
2581;0;3;7;5;6;1;1;5;0.20
2582;0;3;7;5;7;2;2;5;0.40
2583;0;4;7;5;3;-2;1;12;0.08
2584;0;4;7;5;4;-1;1;12;0.08
2585;0;4;7;5;5;0;4;12;0.33
2586;0;4;7;5;6;1;5;12;0.42
2587;0;4;7;5;7;2;1;12;0.08
2588;0;7;7;5;3;-2;1;7;0.14
2589;0;7;7;5;4;-1;1;7;0.14
2590;0;7;7;5;5;0;3;7;0.43
2591;0;7;7;5;6;1;2;7;0.29
2592;0;7;3;6;3;-3;1;7;0.14
2593;0;7;3;6;4;-2;2;7;0.29
2594;0;7;3;6;5;-1;1;7;0.14
2595;0;7;3;6;6;0;1;7;0.14
2596;0;7;3;6;7;1;1;7;0.14
2597;0;7;3;6;8;2;1;7;0.14
2598;0;3;4;6;3;-3;1;7;0.14
2599;0;3;4;6;5;-1;2;7;0.29
2600;0;3;4;6;6;0;3;7;0.43
2601;0;3;4;6;7;1;1;7;0.14
2602;0;4;4;6;3;-3;1;12;0.08
2603;0;4;4;6;4;-2;2;12;0.17
2604;0;4;4;6;5;-1;3;12;0.25
2605;0;4;4;6;6;0;4;12;0.33
2606;0;4;4;6;7;1;1;12;0.08
2607;0;4;4;6;9;3;1;12;0.08
2608;0;7;4;6;3;-3;1;9;0.11
2609;0;7;4;6;4;-2;2;9;0.22
2610;0;7;4;6;5;-1;2;9;0.22
2611;0;7;4;6;6;0;2;9;0.22
2612;0;7;4;6;7;1;2;9;0.22
2613;0;5;5;6;3;-3;7;38;0.18
2614;0;5;5;6;4;-2;7;38;0.18
2615;0;5;5;6;5;-1;12;38;0.32
2616;0;5;5;6;6;0;4;38;0.11
2617;0;5;5;6;7;1;7;38;0.18
2618;0;5;5;6;9;3;1;38;0.03
2619;0;6;5;6;3;-3;4;33;0.12
2620;0;6;5;6;4;-2;5;33;0.15
2621;0;6;5;6;5;-1;7;33;0.21
2622;0;6;5;6;6;0;10;33;0.30
2623;0;6;5;6;7;1;4;33;0.12
2624;0;6;5;6;8;2;3;33;0.09
2625;0;8;5;6;3;-3;1;14;0.07
2626;0;8;5;6;4;-2;1;14;0.07
2627;0;8;5;6;5;-1;7;14;0.50
2628;0;8;5;6;6;0;3;14;0.21
2629;0;8;5;6;7;1;2;14;0.14
2630;0;2;6;6;3;-3;1;4;0.25
2631;0;2;6;6;5;-1;1;4;0.25
2632;0;2;6;6;8;2;2;4;0.50
2633;0;7;6;6;3;-3;1;21;0.05
2634;0;7;6;6;4;-2;5;21;0.24
2635;0;7;6;6;5;-1;6;21;0.29
2636;0;7;6;6;6;0;4;21;0.19
2637;0;7;6;6;7;1;4;21;0.19
2638;0;7;6;6;8;2;1;21;0.05
2639;0;4;7;6;3;-3;1;12;0.08
2640;0;4;7;6;4;-2;5;12;0.42
2641;0;4;7;6;5;-1;3;12;0.25
2642;0;4;7;6;6;0;2;12;0.17
2643;0;4;7;6;8;2;1;12;0.08
2644;0;7;7;6;3;-3;2;16;0.12
2645;0;7;7;6;4;-2;3;16;0.19
2646;0;7;7;6;5;-1;4;16;0.25
2647;0;7;7;6;6;0;1;16;0.06
2648;0;7;7;6;7;1;4;16;0.25
2649;0;7;7;6;8;2;2;16;0.12
2650;0;9;7;6;3;-3;1;3;0.33
2651;0;9;7;6;6;0;1;3;0.33
2652;0;9;7;6;7;1;1;3;0.33
2653;0;2;8;6;3;-3;1;1;1.00
2654;0;3;8;6;3;-3;1;6;0.17
2655;0;3;8;6;4;-2;2;6;0.33
2656;0;3;8;6;6;0;2;6;0.33
2657;0;3;8;6;8;2;1;6;0.17
2658;0;5;8;6;3;-3;1;6;0.17
2659;0;5;8;6;6;0;4;6;0.67
2660;0;5;8;6;7;1;1;6;0.17
2661;0;4;9;6;3;-3;1;5;0.20
2662;0;4;9;6;5;-1;1;5;0.20
2663;0;4;9;6;7;1;1;5;0.20
2664;0;4;9;6;8;2;2;5;0.40
2665;0;6;9;6;3;-3;1;3;0.33
2666;0;6;9;6;6;0;1;3;0.33
2667;0;6;9;6;9;3;1;3;0.33
2668;0;4;3;7;3;-4;2;4;0.50
2669;0;4;3;7;5;-2;1;4;0.25
2670;0;4;3;7;8;1;1;4;0.25
2671;0;8;3;7;3;-4;1;2;0.50
2672;0;8;3;7;6;-1;1;2;0.50
2673;0;6;4;7;3;-4;2;10;0.20
2674;0;6;4;7;4;-3;2;10;0.20
2675;0;6;4;7;5;-2;3;10;0.30
2676;0;6;4;7;6;-1;2;10;0.20
2677;0;6;4;7;7;0;1;10;0.10
2678;0;2;5;7;3;-4;1;3;0.33
2679;0;2;5;7;5;-2;1;3;0.33
2680;0;2;5;7;7;0;1;3;0.33
2681;0;3;5;7;3;-4;1;3;0.33
2682;0;3;5;7;6;-1;1;3;0.33
2683;0;3;5;7;7;0;1;3;0.33
2684;0;4;5;7;3;-4;1;12;0.08
2685;0;4;5;7;4;-3;2;12;0.17
2686;0;4;5;7;5;-2;5;12;0.42
2687;0;4;5;7;6;-1;3;12;0.25
2688;0;4;5;7;7;0;1;12;0.08
2689;0;6;5;7;3;-4;3;25;0.12
2690;0;6;5;7;4;-3;4;25;0.16
2691;0;6;5;7;5;-2;7;25;0.28
2692;0;6;5;7;6;-1;6;25;0.24
2693;0;6;5;7;7;0;3;25;0.12
2694;0;6;5;7;8;1;2;25;0.08
2695;0;7;5;7;3;-4;2;9;0.22
2696;0;7;5;7;4;-3;1;9;0.11
2697;0;7;5;7;5;-2;3;9;0.33
2698;0;7;5;7;6;-1;3;9;0.33
2699;0;3;6;7;3;-4;1;6;0.17
2700;0;3;6;7;5;-2;3;6;0.50
2701;0;3;6;7;7;0;1;6;0.17
2702;0;3;6;7;9;2;1;6;0.17
2703;0;5;6;7;3;-4;1;24;0.04
2704;0;5;6;7;4;-3;4;24;0.17
2705;0;5;6;7;5;-2;9;24;0.38
2706;0;5;6;7;6;-1;5;24;0.21
2707;0;5;6;7;7;0;3;24;0.12
2708;0;5;6;7;9;2;2;24;0.08
2709;0;4;7;7;3;-4;1;8;0.12
2710;0;4;7;7;4;-3;1;8;0.12
2711;0;4;7;7;6;-1;4;8;0.50
2712;0;4;7;7;7;0;1;8;0.12
2713;0;4;7;7;8;1;1;8;0.12
2714;0;7;8;7;3;-4;1;3;0.33
2715;0;7;8;7;5;-2;1;3;0.33
2716;0;7;8;7;7;0;1;3;0.33
2717;0;5;2;8;3;-5;1;2;0.50
2718;0;5;2;8;5;-3;1;2;0.50
2719;0;4;3;8;3;-5;3;3;1.00
2720;0;8;3;8;3;-5;1;2;0.50
2721;0;8;3;8;6;-2;1;2;0.50
2722;0;4;5;8;3;-5;1;6;0.17
2723;0;4;5;8;4;-4;1;6;0.17
2724;0;4;5;8;5;-3;2;6;0.33
2725;0;4;5;8;7;-1;2;6;0.33
2726;0;5;5;8;3;-5;1;11;0.09
2727;0;5;5;8;4;-4;1;11;0.09
2728;0;5;5;8;5;-3;5;11;0.45
2729;0;5;5;8;6;-2;2;11;0.18
2730;0;5;5;8;7;-1;2;11;0.18
2731;0;7;5;8;3;-5;1;4;0.25
2732;0;7;5;8;4;-4;1;4;0.25
2733;0;7;5;8;6;-2;1;4;0.25
2734;0;7;5;8;7;-1;1;4;0.25
2735;0;6;7;8;3;-5;1;2;0.50
2736;0;6;7;8;6;-2;1;2;0.50
2737;0;6;8;8;3;-5;1;4;0.25
2738;0;6;8;8;4;-4;1;4;0.25
2739;0;6;8;8;5;-3;1;4;0.25
2740;0;6;8;8;6;-2;1;4;0.25
2741;0;6;2;9;3;-6;1;2;0.50
2742;0;6;2;9;6;-3;1;2;0.50
2743;0;4;5;9;3;-6;1;2;0.50
2744;0;4;5;9;4;-5;1;2;0.50
2745;0;2;7;9;3;-6;1;2;0.50
2746;0;2;7;9;4;-5;1;2;0.50
2747;0;3;4;10;3;-7;1;2;0.50
2748;0;3;4;10;7;-3;1;2;0.50
2749;0;5;9;1;4;3;1;1;1.00
2750;0;6;9;1;4;3;1;1;1.00
2751;0;3;4;2;4;2;1;1;1.00
2752;0;5;4;2;4;2;1;3;0.33
2753;0;5;4;2;5;3;1;3;0.33
2754;0;5;4;2;9;7;1;3;0.33
2755;0;7;4;2;4;2;1;2;0.50
2756;0;7;4;2;7;5;1;2;0.50
2757;0;3;5;2;4;2;1;2;0.50
2758;0;3;5;2;6;4;1;2;0.50
2759;0;4;5;2;4;2;1;4;0.25
2760;0;4;5;2;5;3;1;4;0.25
2761;0;4;5;2;8;6;1;4;0.25
2762;0;4;5;2;9;7;1;4;0.25
2763;0;5;5;2;4;2;3;5;0.60
2764;0;5;5;2;6;4;1;5;0.20
2765;0;5;5;2;7;5;1;5;0.20
2766;0;8;5;2;4;2;1;2;0.50
2767;0;8;5;2;8;6;1;2;0.50
2768;0;3;6;2;4;2;1;3;0.33
2769;0;3;6;2;7;5;1;3;0.33
2770;0;3;6;2;8;6;1;3;0.33
2771;0;8;6;2;4;2;1;2;0.50
2772;0;8;6;2;7;5;1;2;0.50
2773;0;6;8;2;4;2;1;2;0.50
2774;0;6;8;2;8;6;1;2;0.50
2775;0;3;9;2;4;2;1;1;1.00
2776;0;4;2;3;4;1;1;2;0.50
2777;0;4;2;3;6;3;1;2;0.50
2778;0;5;3;3;4;1;1;6;0.17
2779;0;5;3;3;5;2;2;6;0.33
2780;0;5;3;3;7;4;2;6;0.33
2781;0;5;3;3;9;6;1;6;0.17
2782;0;9;4;3;4;1;1;1;1.00
2783;0;4;5;3;4;1;1;6;0.17
2784;0;4;5;3;5;2;1;6;0.17
2785;0;4;5;3;6;3;3;6;0.50
2786;0;4;5;3;8;5;1;6;0.17
2787;0;4;6;3;4;1;1;7;0.14
2788;0;4;6;3;5;2;1;7;0.14
2789;0;4;6;3;6;3;3;7;0.43
2790;0;4;6;3;7;4;1;7;0.14
2791;0;4;6;3;8;5;1;7;0.14
2792;0;4;7;3;4;1;1;3;0.33
2793;0;4;7;3;5;2;1;3;0.33
2794;0;4;7;3;6;3;1;3;0.33
2795;0;5;7;3;4;1;1;8;0.12
2796;0;5;7;3;5;2;4;8;0.50
2797;0;5;7;3;6;3;2;8;0.25
2798;0;5;7;3;8;5;1;8;0.12
2799;0;8;7;3;4;1;1;1;1.00
2800;0;6;8;3;4;1;1;3;0.33
2801;0;6;8;3;5;2;1;3;0.33
2802;0;6;8;3;6;3;1;3;0.33
2803;0;5;9;3;4;1;1;1;1.00
2804;0;6;2;4;4;0;1;3;0.33
2805;0;6;2;4;5;1;1;3;0.33
2806;0;6;2;4;7;3;1;3;0.33
2807;0;3;3;4;4;0;1;1;1.00
2808;0;4;3;4;4;0;1;5;0.20
2809;0;4;3;4;5;1;1;5;0.20
2810;0;4;3;4;6;2;1;5;0.20
2811;0;4;3;4;9;5;2;5;0.40
2812;0;5;3;4;4;0;2;11;0.18
2813;0;5;3;4;5;1;1;11;0.09
2814;0;5;3;4;6;2;4;11;0.36
2815;0;5;3;4;7;3;2;11;0.18
2816;0;5;3;4;8;4;1;11;0.09
2817;0;5;3;4;10;6;1;11;0.09
2818;0;9;5;4;4;0;1;1;1.00
2819;0;8;6;4;4;0;3;6;0.50
2820;0;8;6;4;5;1;1;6;0.17
2821;0;8;6;4;7;3;2;6;0.33
2822;0;6;7;4;4;0;3;11;0.27
2823;0;6;7;4;5;1;4;11;0.36
2824;0;6;7;4;6;2;2;11;0.18
2825;0;6;7;4;7;3;2;11;0.18
2826;0;4;8;4;4;0;2;6;0.33
2827;0;4;8;4;6;2;2;6;0.33
2828;0;4;8;4;7;3;2;6;0.33
2829;0;6;8;4;4;0;1;4;0.25
2830;0;6;8;4;5;1;1;4;0.25
2831;0;6;8;4;7;3;1;4;0.25
2832;0;6;8;4;8;4;1;4;0.25
2833;0;8;8;4;4;0;2;2;1.00
2834;0;2;9;4;4;0;1;4;0.25
2835;0;2;9;4;6;2;1;4;0.25
2836;0;2;9;4;8;4;2;4;0.50
2837;0;4;9;4;4;0;1;3;0.33
2838;0;4;9;4;5;1;1;3;0.33
2839;0;4;9;4;6;2;1;3;0.33
2840;0;5;9;4;4;0;2;2;1.00
2841;0;8;2;5;4;-1;1;1;1.00
2842;0;5;3;5;4;-1;1;7;0.14
2843;0;5;3;5;5;0;3;7;0.43
2844;0;5;3;5;6;1;2;7;0.29
2845;0;5;3;5;7;2;1;7;0.14
2846;0;6;3;5;4;-1;1;6;0.17
2847;0;6;3;5;5;0;3;6;0.50
2848;0;6;3;5;6;1;1;6;0.17
2849;0;6;3;5;8;3;1;6;0.17
2850;0;10;3;5;4;-1;1;1;1.00
2851;0;3;4;5;4;-1;2;5;0.40
2852;0;3;4;5;7;2;2;5;0.40
2853;0;3;4;5;8;3;1;5;0.20
2854;0;8;4;5;4;-1;2;4;0.50
2855;0;8;4;5;6;1;2;4;0.50
2856;0;9;5;5;4;-1;1;3;0.33
2857;0;9;5;5;7;2;1;3;0.33
2858;0;9;5;5;8;3;1;3;0.33
2859;0;10;6;5;4;-1;3;3;1.00
2860;0;1;8;5;4;-1;1;1;1.00
2861;0;9;9;5;4;-1;1;2;0.50
2862;0;9;9;5;6;1;1;2;0.50
2863;0;8;1;6;4;-2;1;1;1.00
2864;0;5;2;6;4;-2;1;4;0.25
2865;0;5;2;6;5;-1;1;4;0.25
2866;0;5;2;6;6;0;2;4;0.50
2867;0;7;2;6;4;-2;2;4;0.50
2868;0;7;2;6;8;2;2;4;0.50
2869;0;6;3;6;4;-2;1;7;0.14
2870;0;6;3;6;5;-1;1;7;0.14
2871;0;6;3;6;6;0;1;7;0.14
2872;0;6;3;6;7;1;2;7;0.29
2873;0;6;3;6;8;2;2;7;0.29
2874;0;8;3;6;4;-2;1;5;0.20
2875;0;8;3;6;5;-1;2;5;0.40
2876;0;8;3;6;7;1;1;5;0.20
2877;0;8;3;6;8;2;1;5;0.20
2878;0;9;4;6;4;-2;1;6;0.17
2879;0;9;4;6;5;-1;3;6;0.50
2880;0;9;4;6;7;1;1;6;0.17
2881;0;9;4;6;8;2;1;6;0.17
2882;0;3;5;6;4;-2;1;9;0.11
2883;0;3;5;6;5;-1;1;9;0.11
2884;0;3;5;6;6;0;5;9;0.56
2885;0;3;5;6;7;1;1;9;0.11
2886;0;3;5;6;9;3;1;9;0.11
2887;0;9;5;6;4;-2;1;8;0.12
2888;0;9;5;6;5;-1;5;8;0.62
2889;0;9;5;6;6;0;1;8;0.12
2890;0;9;5;6;8;2;1;8;0.12
2891;0;10;5;6;4;-2;1;2;0.50
2892;0;10;5;6;5;-1;1;2;0.50
2893;0;4;6;6;4;-2;5;20;0.25
2894;0;4;6;6;5;-1;6;20;0.30
2895;0;4;6;6;6;0;3;20;0.15
2896;0;4;6;6;7;1;1;20;0.05
2897;0;4;6;6;8;2;4;20;0.20
2898;0;4;6;6;10;4;1;20;0.05
2899;0;9;6;6;4;-2;1;4;0.25
2900;0;9;6;6;5;-1;1;4;0.25
2901;0;9;6;6;6;0;2;4;0.50
2902;0;6;7;6;4;-2;2;18;0.11
2903;0;6;7;6;5;-1;5;18;0.28
2904;0;6;7;6;6;0;4;18;0.22
2905;0;6;7;6;7;1;4;18;0.22
2906;0;6;7;6;8;2;3;18;0.17
2907;0;8;7;6;4;-2;1;7;0.14
2908;0;8;7;6;5;-1;2;7;0.29
2909;0;8;7;6;6;0;1;7;0.14
2910;0;8;7;6;7;1;1;7;0.14
2911;0;8;7;6;8;2;2;7;0.29
2912;0;6;8;6;4;-2;2;9;0.22
2913;0;6;8;6;5;-1;2;9;0.22
2914;0;6;8;6;6;0;3;9;0.33
2915;0;6;8;6;7;1;2;9;0.22
2916;0;7;8;6;4;-2;1;9;0.11
2917;0;7;8;6;5;-1;2;9;0.22
2918;0;7;8;6;6;0;5;9;0.56
2919;0;7;8;6;7;1;1;9;0.11
2920;0;3;9;6;4;-2;1;2;0.50
2921;0;3;9;6;6;0;1;2;0.50
2922;0;4;2;7;4;-3;1;1;1.00
2923;0;5;2;7;4;-3;1;3;0.33
2924;0;5;2;7;7;0;1;3;0.33
2925;0;5;2;7;8;1;1;3;0.33
2926;0;2;4;7;4;-3;1;3;0.33
2927;0;2;4;7;7;0;1;3;0.33
2928;0;2;4;7;8;1;1;3;0.33
2929;0;3;4;7;4;-3;1;4;0.25
2930;0;3;4;7;5;-2;1;4;0.25
2931;0;3;4;7;7;0;1;4;0.25
2932;0;3;4;7;9;2;1;4;0.25
2933;0;8;4;7;4;-3;1;5;0.20
2934;0;8;4;7;5;-2;2;5;0.40
2935;0;8;4;7;6;-1;2;5;0.40
2936;0;9;4;7;4;-3;1;1;1.00
2937;0;5;5;7;4;-3;6;20;0.30
2938;0;5;5;7;5;-2;6;20;0.30
2939;0;5;5;7;6;-1;6;20;0.30
2940;0;5;5;7;7;0;2;20;0.10
2941;0;9;5;7;4;-3;2;3;0.67
2942;0;9;5;7;5;-2;1;3;0.33
2943;0;4;6;7;4;-3;4;15;0.27
2944;0;4;6;7;5;-2;5;15;0.33
2945;0;4;6;7;6;-1;1;15;0.07
2946;0;4;6;7;7;0;3;15;0.20
2947;0;4;6;7;8;1;2;15;0.13
2948;0;7;6;7;4;-3;1;12;0.08
2949;0;7;6;7;5;-2;4;12;0.33
2950;0;7;6;7;6;-1;4;12;0.33
2951;0;7;6;7;7;0;3;12;0.25
2952;0;8;6;7;4;-3;1;5;0.20
2953;0;8;6;7;5;-2;2;5;0.40
2954;0;8;6;7;6;-1;2;5;0.40
2955;0;5;7;7;4;-3;1;8;0.12
2956;0;5;7;7;5;-2;2;8;0.25
2957;0;5;7;7;6;-1;3;8;0.38
2958;0;5;7;7;7;0;1;8;0.12
2959;0;5;7;7;8;1;1;8;0.12
2960;0;1;8;7;4;-3;1;1;1.00
2961;0;3;8;7;4;-3;1;2;0.50
2962;0;3;8;7;7;0;1;2;0.50
2963;0;5;8;7;4;-3;2;9;0.22
2964;0;5;8;7;5;-2;3;9;0.33
2965;0;5;8;7;6;-1;3;9;0.33
2966;0;5;8;7;7;0;1;9;0.11
2967;0;6;8;7;4;-3;1;4;0.25
2968;0;6;8;7;6;-1;1;4;0.25
2969;0;6;8;7;8;1;2;4;0.50
2970;0;8;2;8;4;-4;1;1;1.00
2971;0;2;4;8;4;-4;1;2;0.50
2972;0;2;4;8;7;-1;1;2;0.50
2973;0;4;4;8;4;-4;1;3;0.33
2974;0;4;4;8;6;-2;1;3;0.33
2975;0;4;4;8;7;-1;1;3;0.33
2976;0;5;4;8;4;-4;1;7;0.14
2977;0;5;4;8;5;-3;2;7;0.29
2978;0;5;4;8;6;-2;2;7;0.29
2979;0;5;4;8;7;-1;2;7;0.29
2980;0;6;4;8;4;-4;1;9;0.11
2981;0;6;4;8;5;-3;3;9;0.33
2982;0;6;4;8;6;-2;4;9;0.44
2983;0;6;4;8;8;0;1;9;0.11
2984;0;7;4;8;4;-4;1;3;0.33
2985;0;7;4;8;6;-2;2;3;0.67
2986;0;8;4;8;4;-4;1;2;0.50
2987;0;8;4;8;6;-2;1;2;0.50
2988;0;2;5;8;4;-4;1;2;0.50
2989;0;2;5;8;8;0;1;2;0.50
2990;0;2;6;8;4;-4;1;3;0.33
2991;0;2;6;8;5;-3;1;3;0.33
2992;0;2;6;8;8;0;1;3;0.33
2993;0;7;6;8;4;-4;1;10;0.10
2994;0;7;6;8;5;-3;7;10;0.70
2995;0;7;6;8;8;0;1;10;0.10
2996;0;7;6;8;9;1;1;10;0.10
2997;0;8;6;8;4;-4;1;2;0.50
2998;0;8;6;8;5;-3;1;2;0.50
2999;0;4;7;8;4;-4;1;3;0.33
3000;0;4;7;8;6;-2;2;3;0.67
3001;0;5;7;8;4;-4;1;2;0.50
3002;0;5;7;8;6;-2;1;2;0.50
3003;0;3;8;8;4;-4;1;2;0.50
3004;0;3;8;8;6;-2;1;2;0.50
3005;0;6;9;8;4;-4;1;2;0.50
3006;0;6;9;8;6;-2;1;2;0.50
3007;0;4;1;9;4;-5;1;2;0.50
3008;0;4;1;9;5;-4;1;2;0.50
3009;0;3;2;9;4;-5;1;1;1.00
3010;0;4;2;9;4;-5;1;1;1.00
3011;0;5;2;9;4;-5;1;2;0.50
3012;0;5;2;9;9;0;1;2;0.50
3013;0;7;2;9;4;-5;1;2;0.50
3014;0;7;2;9;5;-4;1;2;0.50
3015;0;6;3;9;4;-5;1;1;1.00
3016;0;2;4;9;4;-5;2;2;1.00
3017;0;6;4;9;4;-5;1;4;0.25
3018;0;6;4;9;5;-4;1;4;0.25
3019;0;6;4;9;6;-3;2;4;0.50
3020;0;4;6;9;4;-5;1;3;0.33
3021;0;4;6;9;6;-3;2;3;0.67
3022;0;5;6;9;4;-5;1;3;0.33
3023;0;5;6;9;7;-2;1;3;0.33
3024;0;5;6;9;8;-1;1;3;0.33
3025;0;7;6;9;4;-5;1;2;0.50
3026;0;7;6;9;5;-4;1;2;0.50
3027;0;3;7;9;4;-5;1;2;0.50
3028;0;3;7;9;6;-3;1;2;0.50
3029;0;4;9;9;4;-5;1;2;0.50
3030;0;4;9;9;5;-4;1;2;0.50
3031;0;5;5;1;5;4;1;1;1.00
3032;0;6;5;1;5;4;1;1;1.00
3033;0;4;3;2;5;3;1;2;0.50
3034;0;4;3;2;7;5;1;2;0.50
3035;0;6;3;2;5;3;1;3;0.33
3036;0;6;3;2;7;5;1;3;0.33
3037;0;6;3;2;9;7;1;3;0.33
3038;0;6;5;2;5;3;2;5;0.40
3039;0;6;5;2;6;4;2;5;0.40
3040;0;6;5;2;7;5;1;5;0.20
3041;0;1;6;2;5;3;1;1;1.00
3042;0;5;6;2;5;3;1;4;0.25
3043;0;5;6;2;7;5;1;4;0.25
3044;0;5;6;2;8;6;1;4;0.25
3045;0;5;6;2;9;7;1;4;0.25
3046;0;6;6;2;5;3;1;4;0.25
3047;0;6;6;2;6;4;1;4;0.25
3048;0;6;6;2;7;5;1;4;0.25
3049;0;6;6;2;9;7;1;4;0.25
3050;0;7;6;2;5;3;1;2;0.50
3051;0;7;6;2;7;5;1;2;0.50
3052;0;5;8;2;5;3;1;2;0.50
3053;0;5;8;2;7;5;1;2;0.50
3054;0;6;2;3;5;2;1;1;1.00
3055;0;6;3;3;5;2;1;2;0.50
3056;0;6;3;3;9;6;1;2;0.50
3057;0;7;6;3;5;2;2;4;0.50
3058;0;7;6;3;7;4;1;4;0.25
3059;0;7;6;3;8;5;1;4;0.25
3060;0;8;6;3;5;2;1;4;0.25
3061;0;8;6;3;6;3;1;4;0.25
3062;0;8;6;3;7;4;1;4;0.25
3063;0;8;6;3;8;5;1;4;0.25
3064;0;2;8;3;5;2;1;1;1.00
3065;0;2;9;3;5;2;1;1;1.00
3066;0;4;10;3;5;2;1;1;1.00
3067;0;4;2;4;5;1;2;3;0.67
3068;0;4;2;4;8;4;1;3;0.33
3069;0;2;3;4;5;1;1;1;1.00
3070;0;7;3;4;5;1;1;3;0.33
3071;0;7;3;4;7;3;1;3;0.33
3072;0;7;3;4;8;4;1;3;0.33
3073;0;8;3;4;5;1;1;1;1.00
3074;0;3;4;4;5;1;3;4;0.75
3075;0;3;4;4;6;2;1;4;0.25
3076;0;6;4;4;5;1;4;12;0.33
3077;0;6;4;4;6;2;3;12;0.25
3078;0;6;4;4;7;3;1;12;0.08
3079;0;6;4;4;8;4;2;12;0.17
3080;0;6;4;4;9;5;2;12;0.17
3081;0;8;5;4;5;1;1;3;0.33
3082;0;8;5;4;7;3;2;3;0.67
3083;0;2;7;4;5;1;1;3;0.33
3084;0;2;7;4;7;3;2;3;0.67
3085;0;5;8;4;5;1;2;5;0.40
3086;0;5;8;4;6;2;1;5;0.20
3087;0;5;8;4;7;3;1;5;0.20
3088;0;5;8;4;8;4;1;5;0.20
3089;0;9;8;4;5;1;1;1;1.00
3090;0;1;9;4;5;1;1;1;1.00
3091;0;9;9;4;5;1;1;1;1.00
3092;0;4;2;5;5;0;1;2;0.50
3093;0;4;2;5;7;2;1;2;0.50
3094;0;5;2;5;5;0;1;3;0.33
3095;0;5;2;5;6;1;1;3;0.33
3096;0;5;2;5;7;2;1;3;0.33
3097;0;7;2;5;5;0;1;2;0.50
3098;0;7;2;5;6;1;1;2;0.50
3099;0;2;4;5;5;0;1;3;0.33
3100;0;2;4;5;7;2;1;3;0.33
3101;0;2;4;5;8;3;1;3;0.33
3102;0;9;4;5;5;0;1;3;0.33
3103;0;9;4;5;7;2;2;3;0.67
3104;0;2;5;5;5;0;1;4;0.25
3105;0;2;5;5;6;1;1;4;0.25
3106;0;2;5;5;7;2;1;4;0.25
3107;0;2;5;5;9;4;1;4;0.25
3108;0;10;5;5;5;0;1;2;0.50
3109;0;10;5;5;6;1;1;2;0.50
3110;0;9;6;5;5;0;1;3;0.33
3111;0;9;6;5;6;1;2;3;0.67
3112;0;2;7;5;5;0;1;1;1.00
3113;0;2;8;5;5;0;2;3;0.67
3114;0;2;8;5;6;1;1;3;0.33
3115;0;3;8;5;5;0;2;4;0.50
3116;0;3;8;5;6;1;1;4;0.25
3117;0;3;8;5;7;2;1;4;0.25
3118;0;4;8;5;5;0;3;5;0.60
3119;0;4;8;5;6;1;1;5;0.20
3120;0;4;8;5;7;2;1;5;0.20
3121;0;5;8;5;5;0;4;9;0.44
3122;0;5;8;5;6;1;1;9;0.11
3123;0;5;8;5;7;2;1;9;0.11
3124;0;5;8;5;8;3;3;9;0.33
3125;0;7;8;5;5;0;2;3;0.67
3126;0;7;8;5;6;1;1;3;0.33
3127;0;8;8;5;5;0;1;4;0.25
3128;0;8;8;5;6;1;2;4;0.50
3129;0;8;8;5;7;2;1;4;0.25
3130;0;3;9;5;5;0;1;1;1.00
3131;0;8;9;5;5;0;1;1;1.00
3132;0;5;10;5;5;0;1;1;1.00
3133;0;6;10;5;5;0;1;2;0.50
3134;0;6;10;5;6;1;1;2;0.50
3135;0;4;1;6;5;-1;2;2;1.00
3136;0;3;2;6;5;-1;1;2;0.50
3137;0;3;2;6;6;0;1;2;0.50
3138;0;2;3;6;5;-1;1;1;1.00
3139;0;2;4;6;5;-1;2;4;0.50
3140;0;2;4;6;7;1;2;4;0.50
3141;0;8;4;6;5;-1;2;5;0.40
3142;0;8;4;6;6;0;2;5;0.40
3143;0;8;4;6;7;1;1;5;0.20
3144;0;2;5;6;5;-1;1;2;0.50
3145;0;2;5;6;6;0;1;2;0.50
3146;0;2;7;6;5;-1;1;2;0.50
3147;0;2;7;6;8;2;1;2;0.50
3148;0;8;8;6;5;-1;1;4;0.25
3149;0;8;8;6;6;0;2;4;0.50
3150;0;8;8;6;7;1;1;4;0.25
3151;0;9;8;6;5;-1;1;1;1.00
3152;0;2;9;6;5;-1;1;1;1.00
3153;0;6;10;6;5;-1;3;3;1.00
3154;0;8;2;7;5;-2;1;2;0.50
3155;0;8;2;7;9;2;1;2;0.50
3156;0;5;3;7;5;-2;3;4;0.75
3157;0;5;3;7;9;2;1;4;0.25
3158;0;1;5;7;5;-2;1;2;0.50
3159;0;1;5;7;6;-1;1;2;0.50
3160;0;8;5;7;5;-2;5;8;0.62
3161;0;8;5;7;6;-1;3;8;0.38
3162;0;1;6;7;5;-2;1;2;0.50
3163;0;1;6;7;7;0;1;2;0.50
3164;0;9;6;7;5;-2;3;3;1.00
3165;0;8;7;7;5;-2;1;3;0.33
3166;0;8;7;7;6;-1;2;3;0.67
3167;0;4;8;7;5;-2;1;5;0.20
3168;0;4;8;7;6;-1;2;5;0.40
3169;0;4;8;7;8;1;2;5;0.40
3170;0;3;9;7;5;-2;1;2;0.50
3171;0;3;9;7;6;-1;1;2;0.50
3172;0;5;9;7;5;-2;1;1;1.00
3173;0;2;1;8;5;-3;1;1;1.00
3174;0;6;2;8;5;-3;2;2;1.00
3175;0;5;3;8;5;-3;2;6;0.33
3176;0;5;3;8;6;-2;1;6;0.17
3177;0;5;3;8;7;-1;1;6;0.17
3178;0;5;3;8;8;0;2;6;0.33
3179;0;6;3;8;5;-3;2;6;0.33
3180;0;6;3;8;6;-2;3;6;0.50
3181;0;6;3;8;7;-1;1;6;0.17
3182;0;4;6;8;5;-3;2;2;1.00
3183;0;9;6;8;5;-3;1;2;0.50
3184;0;9;6;8;6;-2;1;2;0.50
3185;0;2;7;8;5;-3;2;3;0.67
3186;0;2;7;8;6;-2;1;3;0.33
3187;0;3;7;8;5;-3;1;3;0.33
3188;0;3;7;8;7;-1;1;3;0.33
3189;0;3;7;8;9;1;1;3;0.33
3190;0;5;8;8;5;-3;1;1;1.00
3191;0;7;8;8;5;-3;2;3;0.67
3192;0;7;8;8;7;-1;1;3;0.33
3193;0;3;3;9;5;-4;1;3;0.33
3194;0;3;3;9;7;-2;2;3;0.67
3195;0;4;4;9;5;-4;2;3;0.67
3196;0;4;4;9;6;-3;1;3;0.33
3197;0;3;5;9;5;-4;1;3;0.33
3198;0;3;5;9;6;-3;1;3;0.33
3199;0;3;5;9;7;-2;1;3;0.33
3200;0;6;5;9;5;-4;2;2;1.00
3201;0;7;5;9;5;-4;2;3;0.67
3202;0;7;5;9;6;-3;1;3;0.33
3203;0;4;7;9;5;-4;1;1;1.00
3204;0;6;7;9;5;-4;2;4;0.50
3205;0;6;7;9;6;-3;2;4;0.50
3206;0;7;8;9;5;-4;1;1;1.00
3207;0;2;9;9;5;-4;1;1;1.00
3208;0;5;3;10;5;-5;1;1;1.00
3209;0;7;5;10;5;-5;1;1;1.00
3210;0;4;6;10;5;-5;1;1;1.00
3211;0;9;6;10;5;-5;1;1;1.00
3212;0;5;4;1;6;5;1;3;0.33
3213;0;5;4;1;9;8;2;3;0.67
3214;0;7;4;1;6;5;1;1;1.00
3215;0;2;5;1;6;5;1;1;1.00
3216;0;9;5;1;6;5;1;1;1.00
3217;0;3;7;1;6;5;1;2;0.50
3218;0;3;7;1;7;6;1;2;0.50
3219;0;6;8;1;6;5;1;1;1.00
3220;0;4;1;2;6;4;1;1;1.00
3221;0;2;2;2;6;4;1;1;1.00
3222;0;7;3;2;6;4;2;2;1.00
3223;0;9;6;2;6;4;1;1;1.00
3224;0;1;7;2;6;4;1;1;1.00
3225;0;2;7;2;6;4;1;2;0.50
3226;0;2;7;2;7;5;1;2;0.50
3227;0;2;3;3;6;3;1;1;1.00
3228;0;7;3;3;6;3;1;1;1.00
3229;0;8;3;3;6;3;1;1;1.00
3230;0;3;4;3;6;3;1;2;0.50
3231;0;3;4;3;7;4;1;2;0.50
3232;0;2;5;3;6;3;1;1;1.00
3233;0;9;6;3;6;3;1;2;0.50
3234;0;9;6;3;7;4;1;2;0.50
3235;0;2;7;3;6;3;1;1;1.00
3236;0;3;8;3;6;3;2;4;0.50
3237;0;3;8;3;8;5;2;4;0.50
3238;0;7;9;3;6;3;1;1;1.00
3239;0;5;2;4;6;2;1;6;0.17
3240;0;5;2;4;7;3;2;6;0.33
3241;0;5;2;4;8;4;1;6;0.17
3242;0;5;2;4;9;5;2;6;0.33
3243;0;7;2;4;6;2;1;1;1.00
3244;0;8;2;4;6;2;1;1;1.00
3245;0;9;2;4;6;2;1;1;1.00
3246;0;9;3;4;6;2;1;1;1.00
3247;0;2;5;4;6;2;1;1;1.00
3248;0;1;6;4;6;2;1;1;1.00
3249;0;7;7;4;6;2;1;3;0.33
3250;0;7;7;4;7;3;1;3;0.33
3251;0;7;7;4;8;4;1;3;0.33
3252;0;2;8;4;6;2;1;1;1.00
3253;0;7;8;4;6;2;1;2;0.50
3254;0;7;8;4;7;3;1;2;0.50
3255;0;3;9;4;6;2;1;1;1.00
3256;0;6;9;4;6;2;2;3;0.67
3257;0;6;9;4;7;3;1;3;0.33
3258;0;2;3;5;6;1;1;2;0.50
3259;0;2;3;5;7;2;1;2;0.50
3260;0;9;3;5;6;1;1;1;1.00
3261;0;1;6;5;6;1;2;2;1.00
3262;0;9;7;5;6;1;1;2;0.50
3263;0;9;7;5;7;2;1;2;0.50
3264;0;1;9;5;6;1;1;1;1.00
3265;0;2;9;5;6;1;1;1;1.00
3266;0;6;9;5;6;1;1;1;1.00
3267;0;7;9;5;6;1;2;3;0.67
3268;0;7;9;5;7;2;1;3;0.33
3269;0;3;10;5;6;1;1;1;1.00
3270;0;6;2;6;6;0;1;2;0.50
3271;0;6;2;6;8;2;1;2;0.50
3272;0;9;3;6;6;0;1;1;1.00
3273;0;3;7;6;6;0;3;4;0.75
3274;0;3;7;6;9;3;1;4;0.25
3275;0;10;7;6;6;0;1;1;1.00
3276;0;8;9;6;6;0;1;1;1.00
3277;0;9;9;6;6;0;1;1;1.00
3278;0;3;3;7;6;-1;2;2;1.00
3279;0;8;8;7;6;-1;1;1;1.00
3280;0;4;9;7;6;-1;1;1;1.00
3281;0;6;9;7;6;-1;1;2;0.50
3282;0;6;9;7;8;1;1;2;0.50
3283;0;4;10;7;6;-1;1;1;1.00
3284;0;2;2;8;6;-2;1;1;1.00
3285;0;7;3;8;6;-2;1;1;1.00
3286;0;1;4;8;6;-2;1;2;0.50
3287;0;1;4;8;8;0;1;2;0.50
3288;0;9;4;8;6;-2;1;2;0.50
3289;0;9;4;8;7;-1;1;2;0.50
3290;0;1;7;8;6;-2;1;1;1.00
3291;0;7;7;8;6;-2;1;3;0.33
3292;0;7;7;8;7;-1;2;3;0.67
3293;0;8;7;8;6;-2;1;4;0.25
3294;0;8;7;8;8;0;3;4;0.75
3295;0;9;7;8;6;-2;1;1;1.00
3296;0;4;8;8;6;-2;2;2;1.00
3297;0;4;3;9;6;-3;1;1;1.00
3298;0;8;3;9;6;-3;1;1;1.00
3299;0;3;4;9;6;-3;1;2;0.50
3300;0;3;4;9;9;0;1;2;0.50
3301;0;7;4;9;6;-3;1;2;0.50
3302;0;7;4;9;9;0;1;2;0.50
3303;0;8;5;9;6;-3;1;1;1.00
3304;0;3;6;9;6;-3;1;1;1.00
3305;0;6;8;9;6;-3;1;1;1.00
3306;0;5;9;9;6;-3;1;1;1.00
3307;0;5;6;10;6;-4;1;1;1.00
3308;0;6;6;10;6;-4;1;1;1.00
3309;0;8;6;10;6;-4;1;1;1.00
3310;0;3;6;1;7;6;1;1;1.00
3311;0;7;5;2;7;5;1;2;0.50
3312;0;7;5;2;9;7;1;2;0.50
3313;0;6;7;2;7;5;1;1;1.00
3314;0;4;8;2;7;5;1;1;1.00
3315;0;7;8;3;7;4;1;1;1.00
3316;0;8;8;3;7;4;1;1;1.00
3317;0;5;1;5;7;2;2;2;1.00
3318;0;3;2;5;7;2;1;2;0.50
3319;0;3;2;5;8;3;1;2;0.50
3320;0;8;3;5;7;2;1;2;0.50
3321;0;8;3;5;9;4;1;2;0.50
3322;0;2;6;5;7;2;1;2;0.50
3323;0;2;6;5;8;3;1;2;0.50
3324;0;7;1;6;7;1;1;1;1.00
3325;0;1;2;6;7;1;1;1;1.00
3326;0;3;6;6;7;1;2;5;0.40
3327;0;3;6;6;8;2;3;5;0.60
3328;0;7;9;6;7;1;2;3;0.67
3329;0;7;9;6;10;4;1;3;0.33
3330;0;7;2;7;7;0;1;2;0.50
3331;0;7;2;7;9;2;1;2;0.50
3332;0;2;6;7;7;0;1;1;1.00
3333;0;5;1;8;7;-1;1;1;1.00
3334;0;3;5;8;7;-1;1;1;1.00
3335;0;5;4;9;7;-2;1;1;1.00
3336;0;9;6;9;7;-2;1;1;1.00
3337;0;4;2;1;8;7;1;1;1.00
3338;0;7;5;1;8;7;1;1;1.00
3339;0;5;2;2;8;6;1;1;1.00
3340;0;7;4;3;8;5;2;2;1.00
3341;0;3;5;3;8;5;1;2;0.50
3342;0;3;5;3;10;7;1;2;0.50
3343;0;3;6;3;8;5;1;1;1.00
3344;0;9;1;4;8;4;2;2;1.00
3345;0;2;4;4;8;4;1;1;1.00
3346;0;7;1;7;8;1;1;1;1.00
3347;0;2;6;9;8;-1;1;1;1.00
3348;0;3;3;3;9;6;1;1;1.00
3349;0;2;2;6;9;3;1;1;1.00
3350;0;0;4;2;1;-1;1;10;0.10
3351;0;0;4;2;3;1;2;10;0.20
3352;0;0;4;2;4;2;3;10;0.30
3353;0;0;4;2;5;3;2;10;0.20
3354;0;0;4;2;7;5;1;10;0.10
3355;0;0;4;2;9;7;1;10;0.10
3356;0;0;4;4;1;-3;1;49;0.02
3357;0;0;4;4;3;-1;8;49;0.16
3358;0;0;4;4;4;0;4;49;0.08
3359;0;0;4;4;5;1;16;49;0.33
3360;0;0;4;4;6;2;12;49;0.24
3361;0;0;4;4;7;3;2;49;0.04
3362;0;0;4;4;8;4;3;49;0.06
3363;0;0;4;4;9;5;3;49;0.06
3364;0;0;5;4;1;-3;3;98;0.03
3365;0;0;5;4;2;-2;3;98;0.03
3366;0;0;5;4;3;-1;7;98;0.07
3367;0;0;5;4;4;0;13;98;0.13
3368;0;0;5;4;5;1;22;98;0.22
3369;0;0;5;4;6;2;24;98;0.24
3370;0;0;5;4;7;3;18;98;0.18
3371;0;0;5;4;8;4;7;98;0.07
3372;0;0;5;4;9;5;1;98;0.01
3373;0;0;7;4;1;-3;1;45;0.02
3374;0;0;7;4;2;-2;2;45;0.04
3375;0;0;7;4;3;-1;2;45;0.04
3376;0;0;7;4;4;0;6;45;0.13
3377;0;0;7;4;5;1;10;45;0.22
3378;0;0;7;4;6;2;9;45;0.20
3379;0;0;7;4;7;3;10;45;0.22
3380;0;0;7;4;8;4;3;45;0.07
3381;0;0;7;4;9;5;2;45;0.04
3382;0;0;2;5;1;-4;1;14;0.07
3383;0;0;2;5;3;-2;1;14;0.07
3384;0;0;2;5;4;-1;1;14;0.07
3385;0;0;2;5;5;0;4;14;0.29
3386;0;0;2;5;6;1;2;14;0.14
3387;0;0;2;5;7;2;3;14;0.21
3388;0;0;2;5;8;3;2;14;0.14
3389;0;0;5;5;1;-4;1;155;0.01
3390;0;0;5;5;2;-3;5;155;0.03
3391;0;0;5;5;3;-2;21;155;0.14
3392;0;0;5;5;4;-1;23;155;0.15
3393;0;0;5;5;5;0;32;155;0.21
3394;0;0;5;5;6;1;38;155;0.25
3395;0;0;5;5;7;2;20;155;0.13
3396;0;0;5;5;8;3;11;155;0.07
3397;0;0;5;5;9;4;4;155;0.03
3398;0;0;6;5;1;-4;1;161;0.01
3399;0;0;6;5;2;-3;5;161;0.03
3400;0;0;6;5;3;-2;14;161;0.09
3401;0;0;6;5;4;-1;29;161;0.18
3402;0;0;6;5;5;0;43;161;0.27
3403;0;0;6;5;6;1;33;161;0.20
3404;0;0;6;5;7;2;25;161;0.16
3405;0;0;6;5;8;3;9;161;0.06
3406;0;0;6;5;9;4;2;161;0.01
3407;0;0;7;5;1;-4;1;91;0.01
3408;0;0;7;5;2;-3;2;91;0.02
3409;0;0;7;5;3;-2;5;91;0.05
3410;0;0;7;5;4;-1;18;91;0.20
3411;0;0;7;5;5;0;22;91;0.24
3412;0;0;7;5;6;1;26;91;0.29
3413;0;0;7;5;7;2;9;91;0.10
3414;0;0;7;5;8;3;4;91;0.04
3415;0;0;7;5;9;4;3;91;0.03
3416;0;0;7;5;10;5;1;91;0.01
3417;0;0;9;5;1;-4;1;18;0.06
3418;0;0;9;5;2;-3;1;18;0.06
3419;0;0;9;5;3;-2;1;18;0.06
3420;0;0;9;5;4;-1;1;18;0.06
3421;0;0;9;5;5;0;3;18;0.17
3422;0;0;9;5;6;1;8;18;0.44
3423;0;0;9;5;7;2;3;18;0.17
3424;0;0;3;6;1;-5;1;46;0.02
3425;0;0;3;6;2;-4;3;46;0.07
3426;0;0;3;6;3;-3;1;46;0.02
3427;0;0;3;6;4;-2;9;46;0.20
3428;0;0;3;6;5;-1;12;46;0.26
3429;0;0;3;6;6;0;5;46;0.11
3430;0;0;3;6;7;1;6;46;0.13
3431;0;0;3;6;8;2;8;46;0.17
3432;0;0;3;6;9;3;1;46;0.02
3433;0;0;3;7;1;-6;2;20;0.10
3434;0;0;3;7;3;-4;4;20;0.20
3435;0;0;3;7;5;-2;5;20;0.25
3436;0;0;3;7;6;-1;4;20;0.20
3437;0;0;3;7;8;1;3;20;0.15
3438;0;0;3;7;9;2;2;20;0.10
3439;0;0;6;8;1;-7;1;50;0.02
3440;0;0;6;8;2;-6;2;50;0.04
3441;0;0;6;8;3;-5;3;50;0.06
3442;0;0;6;8;4;-4;4;50;0.08
3443;0;0;6;8;5;-3;22;50;0.44
3444;0;0;6;8;6;-2;9;50;0.18
3445;0;0;6;8;7;-1;4;50;0.08
3446;0;0;6;8;8;0;4;50;0.08
3447;0;0;6;8;9;1;1;50;0.02
3448;0;0;5;9;1;-8;1;15;0.07
3449;0;0;5;9;3;-6;1;15;0.07
3450;0;0;5;9;4;-5;2;15;0.13
3451;0;0;5;9;5;-4;5;15;0.33
3452;0;0;5;9;6;-3;4;15;0.27
3453;0;0;5;9;7;-2;1;15;0.07
3454;0;0;5;9;9;0;1;15;0.07
3455;0;0;6;9;1;-8;1;12;0.08
3456;0;0;6;9;4;-5;3;12;0.25
3457;0;0;6;9;5;-4;1;12;0.08
3458;0;0;6;9;6;-3;3;12;0.25
3459;0;0;6;9;7;-2;2;12;0.17
3460;0;0;6;9;8;-1;2;12;0.17
3461;0;0;4;1;2;1;1;5;0.20
3462;0;0;4;1;6;5;2;5;0.40
3463;0;0;4;1;9;8;2;5;0.40
3464;0;0;2;2;2;0;1;3;0.33
3465;0;0;2;2;6;4;1;3;0.33
3466;0;0;2;2;8;6;1;3;0.33
3467;0;0;3;2;2;0;1;9;0.11
3468;0;0;3;2;5;3;2;9;0.22
3469;0;0;3;2;6;4;2;9;0.22
3470;0;0;3;2;7;5;3;9;0.33
3471;0;0;3;2;9;7;1;9;0.11
3472;0;0;5;2;2;0;1;21;0.05
3473;0;0;5;2;4;2;6;21;0.29
3474;0;0;5;2;5;3;3;21;0.14
3475;0;0;5;2;6;4;4;21;0.19
3476;0;0;5;2;7;5;3;21;0.14
3477;0;0;5;2;8;6;2;21;0.10
3478;0;0;5;2;9;7;2;21;0.10
3479;0;0;4;3;2;-1;2;30;0.07
3480;0;0;4;3;3;0;2;30;0.07
3481;0;0;4;3;4;1;5;30;0.17
3482;0;0;4;3;5;2;6;30;0.20
3483;0;0;4;3;6;3;7;30;0.23
3484;0;0;4;3;7;4;4;30;0.13
3485;0;0;4;3;8;5;3;30;0.10
3486;0;0;4;3;9;6;1;30;0.03
3487;0;0;5;3;2;-1;2;52;0.04
3488;0;0;5;3;3;0;6;52;0.12
3489;0;0;5;3;4;1;11;52;0.21
3490;0;0;5;3;5;2;7;52;0.13
3491;0;0;5;3;6;3;14;52;0.27
3492;0;0;5;3;7;4;4;52;0.08
3493;0;0;5;3;8;5;6;52;0.12
3494;0;0;5;3;9;6;1;52;0.02
3495;0;0;5;3;10;7;1;52;0.02
3496;0;0;6;3;2;-1;3;38;0.08
3497;0;0;6;3;3;0;2;38;0.05
3498;0;0;6;3;4;1;6;38;0.16
3499;0;0;6;3;5;2;6;38;0.16
3500;0;0;6;3;6;3;7;38;0.18
3501;0;0;6;3;7;4;7;38;0.18
3502;0;0;6;3;8;5;6;38;0.16
3503;0;0;6;3;9;6;1;38;0.03
3504;0;0;7;3;2;-1;2;22;0.09
3505;0;0;7;3;3;0;1;22;0.05
3506;0;0;7;3;4;1;3;22;0.14
3507;0;0;7;3;5;2;7;22;0.32
3508;0;0;7;3;6;3;7;22;0.32
3509;0;0;7;3;7;4;1;22;0.05
3510;0;0;7;3;8;5;1;22;0.05
3511;0;0;3;4;2;-2;1;29;0.03
3512;0;0;3;4;3;-1;2;29;0.07
3513;0;0;3;4;4;0;4;29;0.14
3514;0;0;3;4;5;1;5;29;0.17
3515;0;0;3;4;6;2;7;29;0.24
3516;0;0;3;4;7;3;4;29;0.14
3517;0;0;3;4;8;4;2;29;0.07
3518;0;0;3;4;9;5;2;29;0.07
3519;0;0;3;4;10;6;2;29;0.07
3520;0;0;6;4;2;-2;4;94;0.04
3521;0;0;6;4;3;-1;10;94;0.11
3522;0;0;6;4;4;0;12;94;0.13
3523;0;0;6;4;5;1;23;94;0.24
3524;0;0;6;4;6;2;22;94;0.23
3525;0;0;6;4;7;3;10;94;0.11
3526;0;0;6;4;8;4;9;94;0.10
3527;0;0;6;4;9;5;4;94;0.04
3528;0;0;3;5;2;-3;2;35;0.06
3529;0;0;3;5;3;-2;2;35;0.06
3530;0;0;3;5;4;-1;5;35;0.14
3531;0;0;3;5;5;0;10;35;0.29
3532;0;0;3;5;6;1;9;35;0.26
3533;0;0;3;5;7;2;3;35;0.09
3534;0;0;3;5;8;3;1;35;0.03
3535;0;0;3;5;9;4;3;35;0.09
3536;0;0;4;5;2;-3;4;86;0.05
3537;0;0;4;5;3;-2;6;86;0.07
3538;0;0;4;5;4;-1;18;86;0.21
3539;0;0;4;5;5;0;21;86;0.24
3540;0;0;4;5;6;1;17;86;0.20
3541;0;0;4;5;7;2;12;86;0.14
3542;0;0;4;5;8;3;6;86;0.07
3543;0;0;4;5;9;4;2;86;0.02
3544;0;0;8;5;2;-3;2;51;0.04
3545;0;0;8;5;3;-2;2;51;0.04
3546;0;0;8;5;4;-1;3;51;0.06
3547;0;0;8;5;5;0;18;51;0.35
3548;0;0;8;5;6;1;14;51;0.27
3549;0;0;8;5;7;2;8;51;0.16
3550;0;0;8;5;8;3;3;51;0.06
3551;0;0;8;5;9;4;1;51;0.02
3552;0;0;1;6;2;-4;1;6;0.17
3553;0;0;1;6;4;-2;1;6;0.17
3554;0;0;1;6;5;-1;2;6;0.33
3555;0;0;1;6;7;1;2;6;0.33
3556;0;0;4;6;2;-4;3;89;0.03
3557;0;0;4;6;3;-3;7;89;0.08
3558;0;0;4;6;4;-2;12;89;0.13
3559;0;0;4;6;5;-1;26;89;0.29
3560;0;0;4;6;6;0;20;89;0.22
3561;0;0;4;6;7;1;15;89;0.17
3562;0;0;4;6;8;2;2;89;0.02
3563;0;0;4;6;9;3;3;89;0.03
3564;0;0;4;6;10;4;1;89;0.01
3565;0;0;5;6;2;-4;4;149;0.03
3566;0;0;5;6;3;-3;15;149;0.10
3567;0;0;5;6;4;-2;22;149;0.15
3568;0;0;5;6;5;-1;44;149;0.30
3569;0;0;5;6;6;0;31;149;0.21
3570;0;0;5;6;7;1;24;149;0.16
3571;0;0;5;6;8;2;5;149;0.03
3572;0;0;5;6;9;3;3;149;0.02
3573;0;0;5;6;10;4;1;149;0.01
3574;0;0;6;6;2;-4;4;135;0.03
3575;0;0;6;6;3;-3;5;135;0.04
3576;0;0;6;6;4;-2;24;135;0.18
3577;0;0;6;6;5;-1;42;135;0.31
3578;0;0;6;6;6;0;27;135;0.20
3579;0;0;6;6;7;1;13;135;0.10
3580;0;0;6;6;8;2;18;135;0.13
3581;0;0;6;6;9;3;1;135;0.01
3582;0;0;6;6;10;4;1;135;0.01
3583;0;0;7;6;2;-4;2;86;0.02
3584;0;0;7;6;3;-3;4;86;0.05
3585;0;0;7;6;4;-2;14;86;0.16
3586;0;0;7;6;5;-1;21;86;0.24
3587;0;0;7;6;6;0;21;86;0.24
3588;0;0;7;6;7;1;12;86;0.14
3589;0;0;7;6;8;2;10;86;0.12
3590;0;0;7;6;9;3;2;86;0.02
3591;0;0;8;6;2;-4;2;49;0.04
3592;0;0;8;6;3;-3;4;49;0.08
3593;0;0;8;6;4;-2;6;49;0.12
3594;0;0;8;6;5;-1;7;49;0.14
3595;0;0;8;6;6;0;22;49;0.45
3596;0;0;8;6;7;1;5;49;0.10
3597;0;0;8;6;8;2;2;49;0.04
3598;0;0;8;6;10;4;1;49;0.02
3599;0;0;9;6;2;-4;1;20;0.05
3600;0;0;9;6;3;-3;2;20;0.10
3601;0;0;9;6;4;-2;3;20;0.15
3602;0;0;9;6;5;-1;3;20;0.15
3603;0;0;9;6;6;0;4;20;0.20
3604;0;0;9;6;7;1;3;20;0.15
3605;0;0;9;6;8;2;2;20;0.10
3606;0;0;9;6;9;3;1;20;0.05
3607;0;0;9;6;10;4;1;20;0.05
3608;0;0;1;7;2;-5;1;2;0.50
3609;0;0;1;7;8;1;1;2;0.50
3610;0;0;2;7;2;-5;2;17;0.12
3611;0;0;2;7;3;-4;1;17;0.06
3612;0;0;2;7;4;-3;3;17;0.18
3613;0;0;2;7;5;-2;1;17;0.06
3614;0;0;2;7;6;-1;2;17;0.12
3615;0;0;2;7;7;0;3;17;0.18
3616;0;0;2;7;8;1;3;17;0.18
3617;0;0;2;7;9;2;2;17;0.12
3618;0;0;4;7;2;-5;6;53;0.11
3619;0;0;4;7;3;-4;3;53;0.06
3620;0;0;4;7;4;-3;8;53;0.15
3621;0;0;4;7;5;-2;12;53;0.23
3622;0;0;4;7;6;-1;12;53;0.23
3623;0;0;4;7;7;0;8;53;0.15
3624;0;0;4;7;8;1;3;53;0.06
3625;0;0;4;7;9;2;1;53;0.02
3626;0;0;6;7;2;-5;1;81;0.01
3627;0;0;6;7;3;-4;2;81;0.02
3628;0;0;6;7;4;-3;11;81;0.14
3629;0;0;6;7;5;-2;30;81;0.37
3630;0;0;6;7;6;-1;18;81;0.22
3631;0;0;6;7;7;0;13;81;0.16
3632;0;0;6;7;8;1;2;81;0.02
3633;0;0;6;7;9;2;4;81;0.05
3634;0;0;7;7;2;-5;3;40;0.07
3635;0;0;7;7;3;-4;3;40;0.07
3636;0;0;7;7;4;-3;3;40;0.07
3637;0;0;7;7;5;-2;7;40;0.17
3638;0;0;7;7;6;-1;16;40;0.40
3639;0;0;7;7;7;0;5;40;0.12
3640;0;0;7;7;8;1;3;40;0.07
3641;0;0;4;8;2;-6;1;32;0.03
3642;0;0;4;8;4;-4;6;32;0.19
3643;0;0;4;8;5;-3;5;32;0.16
3644;0;0;4;8;6;-2;13;32;0.41
3645;0;0;4;8;7;-1;5;32;0.16
3646;0;0;4;8;8;0;2;32;0.06
3647;0;0;5;8;2;-6;2;36;0.06
3648;0;0;5;8;3;-5;4;36;0.11
3649;0;0;5;8;4;-4;5;36;0.14
3650;0;0;5;8;5;-3;9;36;0.25
3651;0;0;5;8;6;-2;6;36;0.17
3652;0;0;5;8;7;-1;9;36;0.25
3653;0;0;5;8;8;0;1;36;0.03
3654;0;0;3;9;2;-7;1;7;0.14
3655;0;0;3;9;4;-5;1;7;0.14
3656;0;0;3;9;5;-4;1;7;0.14
3657;0;0;3;9;6;-3;2;7;0.29
3658;0;0;3;9;7;-2;2;7;0.29
3659;0;0;6;2;3;1;1;20;0.05
3660;0;0;6;2;4;2;3;20;0.15
3661;0;0;6;2;5;3;4;20;0.20
3662;0;0;6;2;6;4;2;20;0.10
3663;0;0;6;2;7;5;6;20;0.30
3664;0;0;6;2;8;6;2;20;0.10
3665;0;0;6;2;9;7;2;20;0.10
3666;0;0;7;2;3;1;2;13;0.15
3667;0;0;7;2;4;2;1;13;0.08
3668;0;0;7;2;5;3;2;13;0.15
3669;0;0;7;2;6;4;4;13;0.31
3670;0;0;7;2;7;5;2;13;0.15
3671;0;0;7;2;9;7;2;13;0.15
3672;0;0;2;3;3;0;1;5;0.20
3673;0;0;2;3;4;1;1;5;0.20
3674;0;0;2;3;5;2;2;5;0.40
3675;0;0;2;3;6;3;1;5;0.20
3676;0;0;3;3;3;0;1;14;0.07
3677;0;0;3;3;4;1;1;14;0.07
3678;0;0;3;3;5;2;3;14;0.21
3679;0;0;3;3;6;3;4;14;0.29
3680;0;0;3;3;7;4;2;14;0.14
3681;0;0;3;3;9;6;3;14;0.21
3682;0;0;8;3;3;0;1;14;0.07
3683;0;0;8;3;4;1;1;14;0.07
3684;0;0;8;3;5;2;2;14;0.14
3685;0;0;8;3;6;3;5;14;0.36
3686;0;0;8;3;7;4;2;14;0.14
3687;0;0;8;3;8;5;2;14;0.14
3688;0;0;8;3;9;6;1;14;0.07
3689;0;0;9;4;3;-1;1;17;0.06
3690;0;0;9;4;4;0;4;17;0.24
3691;0;0;9;4;5;1;3;17;0.18
3692;0;0;9;4;6;2;6;17;0.35
3693;0;0;9;4;7;3;1;17;0.06
3694;0;0;9;4;8;4;2;17;0.12
3695;0;0;5;7;3;-4;8;85;0.09
3696;0;0;5;7;4;-3;15;85;0.18
3697;0;0;5;7;5;-2;29;85;0.34
3698;0;0;5;7;6;-1;23;85;0.27
3699;0;0;5;7;7;0;8;85;0.09
3700;0;0;5;7;8;1;2;85;0.02
3701;0;0;8;7;3;-4;1;25;0.04
3702;0;0;8;7;4;-3;5;25;0.20
3703;0;0;8;7;5;-2;5;25;0.20
3704;0;0;8;7;6;-1;7;25;0.28
3705;0;0;8;7;7;0;3;25;0.12
3706;0;0;8;7;8;1;4;25;0.16
3707;0;0;2;8;3;-5;1;6;0.17
3708;0;0;2;8;4;-4;1;6;0.17
3709;0;0;2;8;5;-3;3;6;0.50
3710;0;0;2;8;6;-2;1;6;0.17
3711;0;0;3;8;3;-5;4;18;0.22
3712;0;0;3;8;5;-3;4;18;0.22
3713;0;0;3;8;6;-2;6;18;0.33
3714;0;0;3;8;7;-1;2;18;0.11
3715;0;0;3;8;8;0;2;18;0.11
3716;0;0;7;8;3;-5;1;22;0.05
3717;0;0;7;8;4;-4;2;22;0.09
3718;0;0;7;8;5;-3;3;22;0.14
3719;0;0;7;8;6;-2;9;22;0.41
3720;0;0;7;8;7;-1;3;22;0.14
3721;0;0;7;8;8;0;3;22;0.14
3722;0;0;7;8;9;1;1;22;0.05
3723;0;0;8;8;3;-5;1;12;0.08
3724;0;0;8;8;4;-4;2;12;0.17
3725;0;0;8;8;5;-3;4;12;0.33
3726;0;0;8;8;6;-2;4;12;0.33
3727;0;0;8;8;7;-1;1;12;0.08
3728;0;0;2;9;3;-6;1;8;0.12
3729;0;0;2;9;4;-5;4;8;0.50
3730;0;0;2;9;5;-4;1;8;0.12
3731;0;0;2;9;6;-3;1;8;0.12
3732;0;0;2;9;9;0;1;8;0.12
3733;0;0;7;9;3;-6;1;9;0.11
3734;0;0;7;9;4;-5;2;9;0.22
3735;0;0;7;9;5;-4;3;9;0.33
3736;0;0;7;9;6;-3;3;9;0.33
3737;0;0;4;10;3;-7;1;2;0.50
3738;0;0;4;10;7;-3;1;2;0.50
3739;0;0;9;1;4;3;2;2;1.00
3740;0;0;8;2;4;2;1;5;0.20
3741;0;0;8;2;5;3;1;5;0.20
3742;0;0;8;2;7;5;2;5;0.40
3743;0;0;8;2;8;6;1;5;0.20
3744;0;0;9;2;4;2;1;1;1.00
3745;0;0;9;3;4;1;1;3;0.33
3746;0;0;9;3;5;2;1;3;0.33
3747;0;0;9;3;6;3;1;3;0.33
3748;0;0;2;4;4;0;1;15;0.07
3749;0;0;2;4;5;1;3;15;0.20
3750;0;0;2;4;6;2;4;15;0.27
3751;0;0;2;4;7;3;3;15;0.20
3752;0;0;2;4;8;4;2;15;0.13
3753;0;0;2;4;9;5;2;15;0.13
3754;0;0;8;4;4;0;5;21;0.24
3755;0;0;8;4;5;1;4;21;0.19
3756;0;0;8;4;6;2;5;21;0.24
3757;0;0;8;4;7;3;5;21;0.24
3758;0;0;8;4;8;4;2;21;0.10
3759;0;0;2;6;4;-2;3;14;0.21
3760;0;0;2;6;5;-1;2;14;0.14
3761;0;0;2;6;6;0;4;14;0.29
3762;0;0;2;6;7;1;1;14;0.07
3763;0;0;2;6;8;2;3;14;0.21
3764;0;0;2;6;9;3;1;14;0.07
3765;0;0;9;8;4;-4;1;2;0.50
3766;0;0;9;8;6;-2;1;2;0.50
3767;0;0;1;9;4;-5;1;2;0.50
3768;0;0;1;9;5;-4;1;2;0.50
3769;0;0;4;9;4;-5;3;14;0.21
3770;0;0;4;9;5;-4;3;14;0.21
3771;0;0;4;9;6;-3;5;14;0.36
3772;0;0;4;9;7;-2;1;14;0.07
3773;0;0;4;9;9;0;2;14;0.14
3774;0;0;9;9;4;-5;1;4;0.25
3775;0;0;9;9;5;-4;2;4;0.50
3776;0;0;9;9;6;-3;1;4;0.25
3777;0;0;5;1;5;4;2;5;0.40
3778;0;0;5;1;6;5;2;5;0.40
3779;0;0;5;1;8;7;1;5;0.20
3780;0;0;10;3;5;2;1;1;1.00
3781;0;0;10;5;5;0;2;4;0.50
3782;0;0;10;5;6;1;2;4;0.50
3783;0;0;10;6;5;-1;3;3;1.00
3784;0;0;9;7;5;-2;2;6;0.33
3785;0;0;9;7;6;-1;3;6;0.50
3786;0;0;9;7;8;1;1;6;0.17
3787;0;0;1;8;5;-3;1;2;0.50
3788;0;0;1;8;7;-1;1;2;0.50
3789;0;0;8;9;5;-4;1;2;0.50
3790;0;0;8;9;6;-3;1;2;0.50
3791;0;0;3;10;5;-5;1;1;1.00
3792;0;0;5;10;5;-5;1;1;1.00
3793;0;0;6;10;5;-5;2;5;0.40
3794;0;0;6;10;6;-4;3;5;0.60
3795;0;0;7;1;6;5;1;2;0.50
3796;0;0;7;1;7;6;1;2;0.50
3797;0;0;8;1;6;5;1;1;1.00
3798;0;0;1;2;6;4;1;1;1.00
3799;0;0;10;7;6;-1;1;1;1.00
3800;0;0;6;1;7;6;1;1;1.00
3801;0;0;1;5;7;2;2;2;1.00
3802;0;0;2;1;8;7;1;1;1.00
3803;0;0;1;4;8;4;2;2;1.00
