;Seq_4;Seq_3;Seq_2;Seq_1;Seq_0;diff;fact_count;pre_count;prob
0;6;7;3;4;1;-3;1;2;0.50
1;6;7;3;4;6;2;1;2;0.50
2;5;5;5;4;1;-3;1;4;0.25
3;5;5;5;4;6;2;2;4;0.50
4;5;5;5;4;8;4;1;4;0.25
5;4;4;6;5;1;-4;1;5;0.20
6;4;4;6;5;5;0;1;5;0.20
7;4;4;6;5;6;1;3;5;0.60
8;6;4;6;6;1;-5;1;9;0.11
9;6;4;6;6;4;-2;2;9;0.22
10;6;4;6;6;5;-1;3;9;0.33
11;6;4;6;6;8;2;1;9;0.11
12;6;4;6;6;9;3;1;9;0.11
13;6;4;6;6;10;4;1;9;0.11
14;5;6;4;7;1;-6;1;5;0.20
15;5;6;4;7;4;-3;2;5;0.40
16;5;6;4;7;7;0;2;5;0.40
17;3;5;6;7;1;-6;1;6;0.17
18;3;5;6;7;3;-4;1;6;0.17
19;3;5;6;7;5;-2;2;6;0.33
20;3;5;6;7;7;0;1;6;0.17
21;3;5;6;7;9;2;1;6;0.17
22;4;6;7;7;1;-6;1;3;0.33
23;4;6;7;7;4;-3;1;3;0.33
24;4;6;7;7;5;-2;1;3;0.33
25;5;4;7;8;1;-7;1;2;0.50
26;5;4;7;8;5;-3;1;2;0.50
27;5;4;4;2;2;0;1;1;1.00
28;6;4;6;3;2;-1;1;2;0.50
29;6;4;6;3;4;1;1;2;0.50
30;5;7;6;3;2;-1;1;2;0.50
31;5;7;6;3;7;4;1;2;0.50
32;5;2;8;3;2;-1;1;1;1.00
33;8;8;9;3;2;-1;1;1;1.00
34;7;6;3;4;2;-2;1;1;1.00
35;6;5;4;4;2;-2;1;2;0.50
36;6;5;4;4;9;5;1;2;0.50
37;4;6;4;4;2;-2;1;3;0.33
38;4;6;4;4;4;0;2;3;0.67
39;5;6;4;4;2;-2;1;5;0.20
40;5;6;4;4;3;-1;1;5;0.20
41;5;6;4;4;5;1;1;5;0.20
42;5;6;4;4;7;3;1;5;0.20
43;5;6;4;4;8;4;1;5;0.20
44;7;8;4;4;2;-2;1;2;0.50
45;7;8;4;4;8;4;1;2;0.50
46;5;6;5;4;2;-2;1;7;0.14
47;5;6;5;4;4;0;2;7;0.29
48;5;6;5;4;5;1;1;7;0.14
49;5;6;5;4;6;2;1;7;0.14
50;5;6;5;4;7;3;2;7;0.29
51;7;8;5;4;2;-2;1;1;1.00
52;3;7;7;4;2;-2;1;2;0.50
53;3;7;7;4;6;2;1;2;0.50
54;5;5;8;4;2;-2;1;3;0.33
55;5;5;8;4;6;2;1;3;0.33
56;5;5;8;4;9;5;1;3;0.33
57;4;5;9;4;2;-2;1;1;1.00
58;6;6;3;5;2;-3;1;1;1.00
59;6;7;3;5;2;-3;1;3;0.33
60;6;7;3;5;5;0;1;3;0.33
61;6;7;3;5;6;1;1;3;0.33
62;6;5;4;5;2;-3;1;5;0.20
63;6;5;4;5;4;-1;1;5;0.20
64;6;5;4;5;6;1;2;5;0.40
65;6;5;4;5;8;3;1;5;0.20
66;5;4;5;5;2;-3;1;4;0.25
67;5;4;5;5;5;0;1;4;0.25
68;5;4;5;5;6;1;1;4;0.25
69;5;4;5;5;7;2;1;4;0.25
70;6;5;5;5;2;-3;1;5;0.20
71;6;5;5;5;4;-1;2;5;0.40
72;6;5;5;5;5;0;1;5;0.20
73;6;5;5;5;6;1;1;5;0.20
74;4;6;5;5;2;-3;1;4;0.25
75;4;6;5;5;3;-2;1;4;0.25
76;4;6;5;5;6;1;1;4;0.25
77;4;6;5;5;7;2;1;4;0.25
78;6;6;5;5;2;-3;1;13;0.08
79;6;6;5;5;3;-2;1;13;0.08
80;6;6;5;5;4;-1;2;13;0.15
81;6;6;5;5;5;0;3;13;0.23
82;6;6;5;5;6;1;4;13;0.31
83;6;6;5;5;8;3;2;13;0.15
84;4;7;5;5;2;-3;1;3;0.33
85;4;7;5;5;7;2;1;3;0.33
86;4;7;5;5;8;3;1;3;0.33
87;3;4;6;5;2;-3;1;2;0.50
88;3;4;6;5;6;1;1;2;0.50
89;7;4;6;5;2;-3;1;6;0.17
90;7;4;6;5;3;-2;1;6;0.17
91;7;4;6;5;4;-1;1;6;0.17
92;7;4;6;5;5;0;1;6;0.17
93;7;4;6;5;6;1;1;6;0.17
94;7;4;6;5;8;3;1;6;0.17
95;6;5;6;5;2;-3;1;7;0.14
96;6;5;6;5;4;-1;2;7;0.29
97;6;5;6;5;5;0;1;7;0.14
98;6;5;6;5;6;1;2;7;0.29
99;6;5;6;5;7;2;1;7;0.14
100;8;6;7;5;2;-3;1;3;0.33
101;8;6;7;5;5;0;1;3;0.33
102;8;6;7;5;8;3;1;3;0.33
103;5;4;3;6;2;-4;1;1;1.00
104;7;3;4;6;2;-4;1;3;0.33
105;7;3;4;6;3;-3;1;3;0.33
106;7;3;4;6;6;0;1;3;0.33
107;6;9;4;6;2;-4;1;1;1.00
108;5;4;5;6;2;-4;1;4;0.25
109;5;4;5;6;6;0;1;4;0.25
110;5;4;5;6;7;1;1;4;0.25
111;5;4;5;6;8;2;1;4;0.25
112;4;3;6;6;2;-4;1;1;1.00
113;6;6;6;6;2;-4;1;9;0.11
114;6;6;6;6;3;-3;2;9;0.22
115;6;6;6;6;5;-1;2;9;0.22
116;6;6;6;6;6;0;2;9;0.22
117;6;6;6;6;7;1;2;9;0.22
118;7;6;6;6;2;-4;1;3;0.33
119;7;6;6;6;6;0;2;3;0.67
120;5;7;7;6;2;-4;1;6;0.17
121;5;7;7;6;5;-1;1;6;0.17
122;5;7;7;6;6;0;1;6;0.17
123;5;7;7;6;7;1;2;6;0.33
124;5;7;7;6;8;2;1;6;0.17
125;6;6;4;7;2;-5;1;4;0.25
126;6;6;4;7;5;-2;2;4;0.50
127;6;6;4;7;6;-1;1;4;0.25
128;9;7;4;7;2;-5;1;1;1.00
129;6;6;5;7;2;-5;1;4;0.25
130;6;6;5;7;5;-2;1;4;0.25
131;6;6;5;7;6;-1;1;4;0.25
132;6;6;5;7;7;0;1;4;0.25
133;5;7;5;7;2;-5;1;5;0.20
134;5;7;5;7;5;-2;3;5;0.60
135;5;7;5;7;7;0;1;5;0.20
136;6;7;5;7;2;-5;1;2;0.50
137;6;7;5;7;4;-3;1;2;0.50
138;8;7;6;7;2;-5;1;1;1.00
139;6;5;7;7;2;-5;1;5;0.20
140;6;5;7;7;4;-3;2;5;0.40
141;6;5;7;7;6;-1;2;5;0.40
142;5;3;8;7;2;-5;1;2;0.50
143;5;3;8;7;6;-1;1;2;0.50
144;5;4;4;8;2;-6;1;1;1.00
145;9;6;4;8;2;-6;1;1;1.00
146;5;8;5;8;2;-6;1;1;1.00
147;6;5;6;8;2;-6;1;4;0.25
148;6;5;6;8;5;-3;1;4;0.25
149;6;5;6;8;7;-1;1;4;0.25
150;6;5;6;8;9;1;1;4;0.25
151;6;5;2;9;2;-7;1;1;1.00
152;5;4;6;9;2;-7;1;3;0.33
153;5;4;6;9;5;-4;1;3;0.33
154;5;4;6;9;7;-2;1;3;0.33
155;5;5;4;1;3;2;1;1;1.00
156;8;5;4;2;3;1;1;1;1.00
157;5;8;4;2;3;1;1;1;1.00
158;5;4;5;2;3;1;1;1;1.00
159;4;5;5;2;3;1;1;1;1.00
160;7;7;6;2;3;1;1;1;1.00
161;6;4;7;2;3;1;1;1;1.00
162;6;5;7;2;3;1;1;1;1.00
163;4;4;8;2;3;1;1;1;1.00
164;4;6;9;2;3;1;1;1;1.00
165;5;5;2;3;3;0;1;1;1.00
166;5;5;4;3;3;0;1;1;1.00
167;4;6;4;3;3;0;1;3;0.33
168;4;6;4;3;5;2;2;3;0.67
169;8;7;4;3;3;0;1;1;1.00
170;6;8;4;3;3;0;1;2;0.50
171;6;8;4;3;8;5;1;2;0.50
172;6;5;5;3;3;0;1;3;0.33
173;6;5;5;3;8;5;2;3;0.67
174;7;5;5;3;3;0;2;3;0.67
175;7;5;5;3;5;2;1;3;0.33
176;3;6;5;3;3;0;1;2;0.50
177;3;6;5;3;5;2;1;2;0.50
178;6;5;6;3;3;0;1;2;0.50
179;6;5;6;3;6;3;1;2;0.50
180;7;6;6;3;3;0;1;3;0.33
181;7;6;6;3;6;3;1;3;0.33
182;7;6;6;3;7;4;1;3;0.33
183;5;8;6;3;3;0;1;1;1.00
184;6;9;6;3;3;0;1;2;0.50
185;6;9;6;3;7;4;1;2;0.50
186;6;3;7;3;3;0;1;2;0.50
187;6;3;7;3;4;1;1;2;0.50
188;6;5;7;3;3;0;1;1;1.00
189;4;6;8;3;3;0;1;4;0.25
190;4;6;8;3;4;1;1;4;0.25
191;4;6;8;3;5;2;1;4;0.25
192;4;6;8;3;6;3;1;4;0.25
193;6;6;8;3;3;0;1;3;0.33
194;6;6;8;3;6;3;1;3;0.33
195;6;6;8;3;7;4;1;3;0.33
196;5;6;9;3;3;0;1;1;1.00
197;4;6;3;4;3;-1;1;1;1.00
198;5;7;3;4;3;-1;1;4;0.25
199;5;7;3;4;4;0;1;4;0.25
200;5;7;3;4;6;2;2;4;0.50
201;8;5;4;4;3;-1;1;2;0.50
202;8;5;4;4;7;3;1;2;0.50
203;4;2;5;4;3;-1;1;1;1.00
204;7;4;5;4;3;-1;1;5;0.20
205;7;4;5;4;4;0;1;5;0.20
206;7;4;5;4;5;1;1;5;0.20
207;7;4;5;4;6;2;2;5;0.40
208;8;5;5;4;3;-1;1;1;1.00
209;7;7;5;4;3;-1;1;2;0.50
210;7;7;5;4;6;2;1;2;0.50
211;3;4;6;4;3;-1;1;4;0.25
212;3;4;6;4;5;1;1;4;0.25
213;3;4;6;4;6;2;2;4;0.50
214;5;4;6;4;3;-1;1;3;0.33
215;5;4;6;4;6;2;2;3;0.67
216;7;4;6;4;3;-1;1;3;0.33
217;7;4;6;4;5;1;1;3;0.33
218;7;4;6;4;8;4;1;3;0.33
219;4;5;6;4;3;-1;2;3;0.67
220;4;5;6;4;7;3;1;3;0.33
221;6;5;6;4;3;-1;2;4;0.50
222;6;5;6;4;7;3;1;4;0.25
223;6;5;6;4;9;5;1;4;0.25
224;8;5;6;4;3;-1;1;2;0.50
225;8;5;6;4;5;1;1;2;0.50
226;7;2;7;4;3;-1;1;2;0.50
227;7;2;7;4;6;2;1;2;0.50
228;3;3;7;4;3;-1;1;3;0.33
229;3;3;7;4;6;2;2;3;0.67
230;5;3;7;4;3;-1;1;1;1.00
231;7;3;7;4;3;-1;1;1;1.00
232;3;4;7;4;3;-1;1;2;0.50
233;3;4;7;4;6;2;1;2;0.50
234;8;6;7;4;3;-1;1;1;1.00
235;6;7;7;4;3;-1;1;2;0.50
236;6;7;7;4;4;0;1;2;0.50
237;7;7;7;4;3;-1;1;1;1.00
238;6;8;7;4;3;-1;1;2;0.50
239;6;8;7;4;5;1;1;2;0.50
240;3;6;8;4;3;-1;1;2;0.50
241;3;6;8;4;6;2;1;2;0.50
242;6;6;8;4;3;-1;1;2;0.50
243;6;6;8;4;6;2;1;2;0.50
244;5;7;8;4;3;-1;1;3;0.33
245;5;7;8;4;4;0;1;3;0.33
246;5;7;8;4;6;2;1;3;0.33
247;6;7;8;4;3;-1;1;1;1.00
248;5;4;2;5;3;-2;1;1;1.00
249;4;7;2;5;3;-2;1;1;1.00
250;8;3;3;5;3;-2;1;1;1.00
251;5;4;3;5;3;-2;1;2;0.50
252;5;4;3;5;5;0;1;2;0.50
253;8;4;3;5;3;-2;1;2;0.50
254;8;4;3;5;6;1;1;2;0.50
255;6;6;4;5;3;-2;1;3;0.33
256;6;6;4;5;4;-1;2;3;0.67
257;7;6;4;5;3;-2;1;4;0.25
258;7;6;4;5;7;2;2;4;0.50
259;7;6;4;5;9;4;1;4;0.25
260;6;7;4;5;3;-2;1;6;0.17
261;6;7;4;5;4;-1;2;6;0.33
262;6;7;4;5;5;0;1;6;0.17
263;6;7;4;5;7;2;2;6;0.33
264;9;7;4;5;3;-2;1;1;1.00
265;5;5;5;5;3;-2;2;4;0.50
266;5;5;5;5;4;-1;1;4;0.25
267;5;5;5;5;8;3;1;4;0.25
268;5;6;5;5;3;-2;1;7;0.14
269;5;6;5;5;6;1;3;7;0.43
270;5;6;5;5;7;2;1;7;0.14
271;5;6;5;5;8;3;1;7;0.14
272;5;6;5;5;9;4;1;7;0.14
273;6;7;5;5;3;-2;2;7;0.29
274;6;7;5;5;4;-1;2;7;0.29
275;6;7;5;5;5;0;2;7;0.29
276;6;7;5;5;6;1;1;7;0.14
277;7;7;5;5;3;-2;1;2;0.50
278;7;7;5;5;7;2;1;2;0.50
279;5;9;5;5;3;-2;1;4;0.25
280;5;9;5;5;4;-1;2;4;0.50
281;5;9;5;5;5;0;1;4;0.25
282;6;9;5;5;3;-2;1;2;0.50
283;6;9;5;5;5;0;1;2;0.50
284;4;3;6;5;3;-2;1;1;1.00
285;6;3;6;5;3;-2;1;4;0.25
286;6;3;6;5;6;1;3;4;0.75
287;5;6;6;5;3;-2;1;4;0.25
288;5;6;6;5;5;0;2;4;0.50
289;5;6;6;5;7;2;1;4;0.25
290;4;8;6;5;3;-2;1;3;0.33
291;4;8;6;5;7;2;2;3;0.67
292;5;9;6;5;3;-2;1;1;1.00
293;8;9;6;5;3;-2;1;1;1.00
294;6;4;7;5;3;-2;1;3;0.33
295;6;4;7;5;6;1;1;3;0.33
296;6;4;7;5;8;3;1;3;0.33
297;7;5;7;5;3;-2;1;8;0.12
298;7;5;7;5;4;-1;1;8;0.12
299;7;5;7;5;5;0;1;8;0.12
300;7;5;7;5;6;1;2;8;0.25
301;7;5;7;5;7;2;1;8;0.12
302;7;5;7;5;8;3;1;8;0.12
303;7;5;7;5;10;5;1;8;0.12
304;9;5;7;5;3;-2;1;2;0.50
305;9;5;7;5;6;1;1;2;0.50
306;5;6;7;5;3;-2;1;6;0.17
307;5;6;7;5;4;-1;1;6;0.17
308;5;6;7;5;5;0;2;6;0.33
309;5;6;7;5;6;1;1;6;0.17
310;5;6;7;5;7;2;1;6;0.17
311;6;7;7;5;3;-2;1;4;0.25
312;6;7;7;5;4;-1;1;4;0.25
313;6;7;7;5;7;2;1;4;0.25
314;6;7;7;5;9;4;1;4;0.25
315;4;8;7;5;3;-2;1;3;0.33
316;4;8;7;5;6;1;1;3;0.33
317;4;8;7;5;7;2;1;3;0.33
318;7;8;7;5;3;-2;1;4;0.25
319;7;8;7;5;5;0;2;4;0.50
320;7;8;7;5;7;2;1;4;0.25
321;5;9;7;5;3;-2;1;1;1.00
322;6;9;7;5;3;-2;1;1;1.00
323;5;5;8;5;3;-2;1;4;0.25
324;5;5;8;5;4;-1;1;4;0.25
325;5;5;8;5;6;1;1;4;0.25
326;5;5;8;5;10;5;1;4;0.25
327;5;6;8;5;3;-2;1;1;1.00
328;8;4;9;5;3;-2;1;1;1.00
329;6;8;9;5;3;-2;1;2;0.50
330;6;8;9;5;7;2;1;2;0.50
331;7;9;3;6;3;-3;1;1;1.00
332;8;5;4;6;3;-3;1;2;0.50
333;8;5;4;6;6;0;1;2;0.50
334;10;5;4;6;3;-3;1;1;1.00
335;4;6;4;6;3;-3;1;6;0.17
336;4;6;4;6;4;-2;1;6;0.17
337;4;6;4;6;5;-1;3;6;0.50
338;4;6;4;6;6;0;1;6;0.17
339;6;6;4;6;3;-3;1;4;0.25
340;6;6;4;6;4;-2;1;4;0.25
341;6;6;4;6;5;-1;2;4;0.50
342;4;7;4;6;3;-3;1;6;0.17
343;4;7;4;6;4;-2;1;6;0.17
344;4;7;4;6;5;-1;1;6;0.17
345;4;7;4;6;6;0;3;6;0.50
346;4;8;4;6;3;-3;1;1;1.00
347;5;5;5;6;3;-3;1;9;0.11
348;5;5;5;6;4;-2;2;9;0.22
349;5;5;5;6;6;0;2;9;0.22
350;5;5;5;6;7;1;3;9;0.33
351;5;5;5;6;8;2;1;9;0.11
352;6;5;5;6;3;-3;1;9;0.11
353;6;5;5;6;4;-2;3;9;0.33
354;6;5;5;6;5;-1;2;9;0.22
355;6;5;5;6;7;1;3;9;0.33
356;10;5;5;6;3;-3;1;1;1.00
357;4;6;5;6;3;-3;2;10;0.20
358;4;6;5;6;4;-2;1;10;0.10
359;4;6;5;6;5;-1;2;10;0.20
360;4;6;5;6;6;0;1;10;0.10
361;4;6;5;6;7;1;3;10;0.30
362;4;6;5;6;8;2;1;10;0.10
363;5;7;5;6;3;-3;1;6;0.17
364;5;7;5;6;4;-2;2;6;0.33
365;5;7;5;6;5;-1;3;6;0.50
366;5;8;5;6;3;-3;1;4;0.25
367;5;8;5;6;4;-2;1;4;0.25
368;5;8;5;6;5;-1;1;4;0.25
369;5;8;5;6;6;0;1;4;0.25
370;7;8;5;6;3;-3;1;1;1.00
371;1;3;6;6;3;-3;1;1;1.00
372;4;4;6;6;3;-3;1;6;0.17
373;4;4;6;6;6;0;2;6;0.33
374;4;4;6;6;7;1;3;6;0.50
375;4;5;6;6;3;-3;1;5;0.20
376;4;5;6;6;4;-2;1;5;0.20
377;4;5;6;6;5;-1;1;5;0.20
378;4;5;6;6;6;0;1;5;0.20
379;4;5;6;6;8;2;1;5;0.20
380;5;5;6;6;3;-3;1;4;0.25
381;5;5;6;6;6;0;2;4;0.50
382;5;5;6;6;7;1;1;4;0.25
383;6;5;6;6;3;-3;1;5;0.20
384;6;5;6;6;5;-1;2;5;0.40
385;6;5;6;6;6;0;1;5;0.20
386;6;5;6;6;7;1;1;5;0.20
387;9;5;6;6;3;-3;1;2;0.50
388;9;5;6;6;7;1;1;2;0.50
389;1;6;6;6;3;-3;1;1;1.00
390;4;6;6;6;3;-3;1;8;0.12
391;4;6;6;6;5;-1;2;8;0.25
392;4;6;6;6;6;0;3;8;0.38
393;4;6;6;6;7;1;2;8;0.25
394;5;7;6;6;3;-3;1;4;0.25
395;5;7;6;6;5;-1;1;4;0.25
396;5;7;6;6;6;0;1;4;0.25
397;5;7;6;6;7;1;1;4;0.25
398;6;7;6;6;3;-3;2;4;0.50
399;6;7;6;6;4;-2;1;4;0.25
400;6;7;6;6;6;0;1;4;0.25
401;4;8;6;6;3;-3;1;1;1.00
402;5;3;7;6;3;-3;1;3;0.33
403;5;3;7;6;6;0;2;3;0.67
404;5;4;7;6;3;-3;1;2;0.50
405;5;4;7;6;5;-1;1;2;0.50
406;6;5;7;6;3;-3;2;6;0.33
407;6;5;7;6;4;-2;1;6;0.17
408;6;5;7;6;6;0;2;6;0.33
409;6;5;7;6;7;1;1;6;0.17
410;5;6;7;6;3;-3;1;6;0.17
411;5;6;7;6;4;-2;1;6;0.17
412;5;6;7;6;5;-1;1;6;0.17
413;5;6;7;6;6;0;2;6;0.33
414;5;6;7;6;7;1;1;6;0.17
415;4;7;7;6;3;-3;1;3;0.33
416;4;7;7;6;5;-1;1;3;0.33
417;4;7;7;6;9;3;1;3;0.33
418;6;7;7;6;3;-3;1;4;0.25
419;6;7;7;6;7;1;1;4;0.25
420;6;7;7;6;9;3;1;4;0.25
421;6;7;7;6;10;4;1;4;0.25
422;5;5;8;6;3;-3;1;2;0.50
423;5;5;8;6;7;1;1;2;0.50
424;7;6;8;6;3;-3;1;2;0.50
425;7;6;8;6;7;1;1;2;0.50
426;6;7;8;6;3;-3;1;1;1.00
427;6;4;9;6;3;-3;1;1;1.00
428;6;6;9;6;3;-3;1;2;0.50
429;6;6;9;6;4;-2;1;2;0.50
430;7;6;9;6;3;-3;1;1;1.00
431;3;5;2;7;3;-4;1;1;1.00
432;4;3;3;7;3;-4;1;3;0.33
433;4;3;3;7;4;-3;1;3;0.33
434;4;3;3;7;5;-2;1;3;0.33
435;7;6;3;7;3;-4;1;3;0.33
436;7;6;3;7;4;-3;2;3;0.67
437;8;6;3;7;3;-4;1;1;1.00
438;3;7;4;7;3;-4;1;1;1.00
439;5;3;5;7;3;-4;1;1;1.00
440;6;3;5;7;3;-4;1;3;0.33
441;6;3;5;7;5;-2;1;3;0.33
442;6;3;5;7;7;0;1;3;0.33
443;6;4;5;7;3;-4;1;5;0.20
444;6;4;5;7;4;-3;2;5;0.40
445;6;4;5;7;5;-2;1;5;0.20
446;6;4;5;7;8;1;1;5;0.20
447;7;4;5;7;3;-4;2;3;0.67
448;7;4;5;7;6;-1;1;3;0.33
449;8;4;5;7;3;-4;1;2;0.50
450;8;4;5;7;7;0;1;2;0.50
451;9;4;5;7;3;-4;1;1;1.00
452;5;5;5;7;3;-4;1;8;0.12
453;5;5;5;7;4;-3;1;8;0.12
454;5;5;5;7;6;-1;1;8;0.12
455;5;5;5;7;7;0;2;8;0.25
456;5;5;5;7;8;1;2;8;0.25
457;5;5;5;7;9;2;1;8;0.12
458;7;5;5;7;3;-4;1;3;0.33
459;7;5;5;7;4;-3;1;3;0.33
460;7;5;5;7;6;-1;1;3;0.33
461;5;6;5;7;3;-4;1;6;0.17
462;5;6;5;7;5;-2;1;6;0.17
463;5;6;5;7;6;-1;3;6;0.50
464;5;6;5;7;7;0;1;6;0.17
465;8;7;5;7;3;-4;1;2;0.50
466;8;7;5;7;5;-2;1;2;0.50
467;6;8;5;7;3;-4;1;2;0.50
468;6;8;5;7;4;-3;1;2;0.50
469;6;4;6;7;3;-4;1;3;0.33
470;6;4;6;7;4;-3;1;3;0.33
471;6;4;6;7;7;0;1;3;0.33
472;4;5;6;7;3;-4;1;5;0.20
473;4;5;6;7;4;-3;3;5;0.60
474;4;5;6;7;7;0;1;5;0.20
475;3;6;6;7;3;-4;1;2;0.50
476;3;6;6;7;4;-3;1;2;0.50
477;4;6;6;7;3;-4;1;6;0.17
478;4;6;6;7;4;-3;2;6;0.33
479;4;6;6;7;5;-2;3;6;0.50
480;5;7;6;7;3;-4;1;4;0.25
481;5;7;6;7;6;-1;2;4;0.50
482;5;7;6;7;8;1;1;4;0.25
483;7;3;7;7;3;-4;1;2;0.50
484;7;3;7;7;4;-3;1;2;0.50
485;3;6;7;7;3;-4;1;2;0.50
486;3;6;7;7;5;-2;1;2;0.50
487;6;7;7;7;3;-4;1;2;0.50
488;6;7;7;7;5;-2;1;2;0.50
489;5;5;8;7;3;-4;1;2;0.50
490;5;5;8;7;5;-2;1;2;0.50
491;6;6;8;7;3;-4;1;1;1.00
492;7;7;8;7;3;-4;1;1;1.00
493;5;5;2;8;3;-5;1;1;1.00
494;6;6;3;8;3;-5;1;2;0.50
495;6;6;3;8;8;0;1;2;0.50
496;5;7;3;8;3;-5;1;3;0.33
497;5;7;3;8;5;-3;1;3;0.33
498;5;7;3;8;8;0;1;3;0.33
499;3;2;4;8;3;-5;1;1;1.00
500;8;5;5;8;3;-5;1;1;1.00
501;6;6;5;8;3;-5;1;4;0.25
502;6;6;5;8;4;-4;1;4;0.25
503;6;6;5;8;5;-3;1;4;0.25
504;6;6;5;8;8;0;1;4;0.25
505;7;6;5;8;3;-5;1;2;0.50
506;7;6;5;8;7;-1;1;2;0.50
507;4;4;6;8;3;-5;1;2;0.50
508;4;4;6;8;4;-4;1;2;0.50
509;5;4;6;8;3;-5;1;1;1.00
510;6;4;6;8;3;-5;1;2;0.50
511;6;4;6;8;5;-3;1;2;0.50
512;7;4;6;8;3;-5;1;1;1.00
513;5;5;6;8;3;-5;1;1;1.00
514;8;5;6;8;3;-5;1;1;1.00
515;4;6;6;8;3;-5;1;3;0.33
516;4;6;6;8;5;-3;1;3;0.33
517;4;6;6;8;6;-2;1;3;0.33
518;5;6;6;8;3;-5;1;2;0.50
519;5;6;6;8;4;-4;1;2;0.50
520;7;6;6;8;3;-5;1;1;1.00
521;5;3;7;8;3;-5;1;1;1.00
522;7;4;7;8;3;-5;1;3;0.33
523;7;4;7;8;4;-4;1;3;0.33
524;7;4;7;8;7;-1;1;3;0.33
525;6;5;7;8;3;-5;1;1;1.00
526;3;4;8;8;3;-5;1;1;1.00
527;6;5;8;8;3;-5;1;1;1.00
528;6;6;9;8;3;-5;1;1;1.00
529;6;5;6;9;3;-6;1;1;1.00
530;5;5;7;9;3;-6;1;1;1.00
531;8;8;8;9;3;-6;1;1;1.00
532;4;6;5;1;4;3;1;1;1.00
533;7;6;3;2;4;2;1;1;1.00
534;2;8;3;2;4;2;1;1;1.00
535;8;9;3;2;4;2;1;1;1.00
536;8;4;4;2;4;2;1;1;1.00
537;7;7;4;2;4;2;1;1;1.00
538;5;9;4;2;4;2;1;1;1.00
539;6;5;5;2;4;2;1;2;0.50
540;6;5;5;2;7;5;1;2;0.50
541;4;6;5;2;4;2;1;2;0.50
542;4;6;5;2;9;7;1;2;0.50
543;9;4;6;2;4;2;1;1;1.00
544;8;5;8;2;4;2;1;1;1.00
545;5;4;2;3;4;1;1;1;1.00
546;7;6;2;3;4;1;1;1;1.00
547;6;9;2;3;4;1;1;1;1.00
548;6;4;3;3;4;1;1;1;1.00
549;3;7;3;3;4;1;1;1;1.00
550;6;8;3;3;4;1;1;2;0.50
551;6;8;3;3;5;2;1;2;0.50
552;5;6;4;3;4;1;1;5;0.20
553;5;6;4;3;5;2;1;5;0.20
554;5;6;4;3;6;3;2;5;0.40
555;5;6;4;3;7;4;1;5;0.20
556;3;7;4;3;4;1;1;3;0.33
557;3;7;4;3;5;2;1;3;0.33
558;3;7;4;3;6;3;1;3;0.33
559;7;7;4;3;4;1;1;2;0.50
560;7;7;4;3;5;2;1;2;0.50
561;5;5;5;3;4;1;1;2;0.50
562;5;5;5;3;7;4;1;2;0.50
563;9;5;5;3;4;1;1;2;0.50
564;9;5;5;3;6;3;1;2;0.50
565;5;7;5;3;4;1;2;2;1.00
566;4;9;5;3;4;1;1;1;1.00
567;5;5;6;3;4;1;1;3;0.33
568;5;5;6;3;5;2;1;3;0.33
569;5;5;6;3;6;3;1;3;0.33
570;5;6;6;3;4;1;1;4;0.25
571;5;6;6;3;6;3;1;4;0.25
572;5;6;6;3;7;4;1;4;0.25
573;5;6;6;3;8;5;1;4;0.25
574;6;6;6;3;4;1;1;4;0.25
575;6;6;6;3;5;2;1;4;0.25
576;6;6;6;3;6;3;2;4;0.50
577;6;7;6;3;4;1;1;1;1.00
578;4;9;6;3;4;1;1;1;1.00
579;5;2;7;3;4;1;1;1;1.00
580;3;3;7;3;4;1;1;1;1.00
581;4;5;7;3;4;1;2;5;0.40
582;4;5;7;3;5;2;1;5;0.20
583;4;5;7;3;6;3;1;5;0.20
584;4;5;7;3;7;4;1;5;0.20
585;7;5;7;3;4;1;1;1;1.00
586;8;5;7;3;4;1;1;1;1.00
587;4;6;7;3;4;1;1;1;1.00
588;6;6;7;3;4;1;1;2;0.50
589;6;6;7;3;5;2;1;2;0.50
590;5;6;8;3;4;1;2;2;1.00
591;5;8;8;3;4;1;1;1;1.00
592;6;9;8;3;4;1;1;1;1.00
593;7;4;3;4;4;0;1;2;0.50
594;7;4;3;4;6;2;1;2;0.50
595;3;7;3;4;4;0;1;2;0.50
596;3;7;3;4;7;3;1;2;0.50
597;6;8;3;4;4;0;1;3;0.33
598;6;8;3;4;6;2;1;3;0.33
599;6;8;3;4;8;4;1;3;0.33
600;7;4;4;4;4;0;1;1;1.00
601;5;5;4;4;4;0;1;2;0.50
602;5;5;4;4;5;1;1;2;0.50
603;7;5;4;4;4;0;1;4;0.25
604;7;5;4;4;6;2;2;4;0.50
605;7;5;4;4;9;5;1;4;0.25
606;9;5;4;4;4;0;1;1;1.00
607;7;7;4;4;4;0;1;2;0.50
608;7;7;4;4;6;2;1;2;0.50
609;4;3;5;4;4;0;1;2;0.50
610;4;3;5;4;5;1;1;2;0.50
611;6;3;5;4;4;0;1;1;1.00
612;7;5;5;4;4;0;1;3;0.33
613;7;5;5;4;5;1;1;3;0.33
614;7;5;5;4;6;2;1;3;0.33
615;9;5;5;4;4;0;1;2;0.50
616;9;5;5;4;6;2;1;2;0.50
617;2;7;5;4;4;0;1;1;1.00
618;4;7;5;4;4;0;1;4;0.25
619;4;7;5;4;6;2;1;4;0.25
620;4;7;5;4;7;3;1;4;0.25
621;4;7;5;4;8;4;1;4;0.25
622;5;7;5;4;4;0;1;1;1.00
623;6;7;5;4;4;0;1;6;0.17
624;6;7;5;4;5;1;2;6;0.33
625;6;7;5;4;6;2;1;6;0.17
626;6;7;5;4;8;4;2;6;0.33
627;5;8;5;4;4;0;2;3;0.67
628;5;8;5;4;6;2;1;3;0.33
629;6;9;5;4;4;0;1;1;1.00
630;7;3;6;4;4;0;1;2;0.50
631;7;3;6;4;6;2;1;2;0.50
632;6;4;6;4;4;0;2;5;0.40
633;6;4;6;4;5;1;2;5;0.40
634;6;4;6;4;6;2;1;5;0.20
635;9;4;6;4;4;0;1;2;0.50
636;9;4;6;4;6;2;1;2;0.50
637;5;5;6;4;4;0;3;7;0.43
638;5;5;6;4;6;2;2;7;0.29
639;5;5;6;4;7;3;2;7;0.29
640;7;5;6;4;4;0;2;5;0.40
641;7;5;6;4;5;1;2;5;0.40
642;7;5;6;4;7;3;1;5;0.20
643;4;6;6;4;4;0;1;5;0.20
644;4;6;6;4;5;1;1;5;0.20
645;4;6;6;4;6;2;1;5;0.20
646;4;6;6;4;7;3;2;5;0.40
647;5;6;6;4;4;0;2;4;0.50
648;5;6;6;4;6;2;1;4;0.25
649;5;6;6;4;7;3;1;4;0.25
650;6;7;6;4;4;0;1;3;0.33
651;6;7;6;4;6;2;2;3;0.67
652;6;3;7;4;4;0;1;4;0.25
653;6;3;7;4;6;2;2;4;0.50
654;6;3;7;4;7;3;1;4;0.25
655;8;4;7;4;4;0;1;1;1.00
656;4;5;7;4;4;0;1;2;0.50
657;4;5;7;4;5;1;1;2;0.50
658;5;5;7;4;4;0;1;3;0.33
659;5;5;7;4;5;1;1;3;0.33
660;5;5;7;4;7;3;1;3;0.33
661;6;5;7;4;4;0;1;2;0.50
662;6;5;7;4;5;1;1;2;0.50
663;5;6;7;4;4;0;2;5;0.40
664;5;6;7;4;5;1;1;5;0.20
665;5;6;7;4;6;2;2;5;0.40
666;5;7;7;4;4;0;1;6;0.17
667;5;7;7;4;5;1;1;6;0.17
668;5;7;7;4;6;2;1;6;0.17
669;5;7;7;4;8;4;2;6;0.33
670;5;7;7;4;9;5;1;6;0.17
671;5;8;7;4;4;0;1;2;0.50
672;5;8;7;4;7;3;1;2;0.50
673;7;8;7;4;4;0;1;2;0.50
674;7;8;7;4;7;3;1;2;0.50
675;4;4;8;4;4;0;1;3;0.33
676;4;4;8;4;7;3;1;3;0.33
677;4;4;8;4;9;5;1;3;0.33
678;4;7;8;4;4;0;1;1;1.00
679;6;5;9;4;4;0;2;2;1.00
680;4;4;2;5;4;-1;1;2;0.50
681;4;4;2;5;6;1;1;2;0.50
682;5;7;2;5;4;-1;1;1;1.00
683;4;4;3;5;4;-1;1;2;0.50
684;4;4;3;5;6;1;1;2;0.50
685;7;4;3;5;4;-1;1;5;0.20
686;7;4;3;5;6;1;1;5;0.20
687;7;4;3;5;7;2;1;5;0.20
688;7;4;3;5;8;3;1;5;0.20
689;7;4;3;5;9;4;1;5;0.20
690;3;5;3;5;4;-1;1;2;0.50
691;3;5;3;5;6;1;1;2;0.50
692;5;6;3;5;4;-1;1;3;0.33
693;5;6;3;5;6;1;2;3;0.67
694;4;5;4;5;4;-1;1;2;0.50
695;4;5;4;5;8;3;1;2;0.50
696;4;6;4;5;4;-1;1;5;0.20
697;4;6;4;5;6;1;2;5;0.40
698;4;6;4;5;7;2;1;5;0.20
699;4;6;4;5;9;4;1;5;0.20
700;5;6;4;5;4;-1;1;4;0.25
701;5;6;4;5;5;0;2;4;0.50
702;5;6;4;5;6;1;1;4;0.25
703;4;7;4;5;4;-1;1;1;1.00
704;5;7;4;5;4;-1;1;4;0.25
705;5;7;4;5;5;0;1;4;0.25
706;5;7;4;5;7;2;1;4;0.25
707;5;7;4;5;8;3;1;4;0.25
708;7;7;4;5;4;-1;1;1;1.00
709;4;3;5;5;4;-1;1;3;0.33
710;4;3;5;5;5;0;1;3;0.33
711;4;3;5;5;6;1;1;3;0.33
712;3;4;5;5;4;-1;1;1;1.00
713;6;4;5;5;4;-1;1;4;0.25
714;6;4;5;5;5;0;2;4;0.50
715;6;4;5;5;8;3;1;4;0.25
716;7;4;5;5;4;-1;1;3;0.33
717;7;4;5;5;5;0;1;3;0.33
718;7;4;5;5;6;1;1;3;0.33
719;2;5;5;5;4;-1;1;1;1.00
720;5;7;5;5;4;-1;1;8;0.12
721;5;7;5;5;5;0;3;8;0.38
722;5;7;5;5;6;1;1;8;0.12
723;5;7;5;5;7;2;1;8;0.12
724;5;7;5;5;8;3;1;8;0.12
725;5;7;5;5;10;5;1;8;0.12
726;6;8;5;5;4;-1;1;1;1.00
727;3;3;6;5;4;-1;1;1;1.00
728;6;4;6;5;4;-1;1;6;0.17
729;6;4;6;5;5;0;2;6;0.33
730;6;4;6;5;6;1;3;6;0.50
731;3;5;6;5;4;-1;2;6;0.33
732;3;5;6;5;5;0;1;6;0.17
733;3;5;6;5;6;1;1;6;0.17
734;3;5;6;5;7;2;2;6;0.33
735;5;5;6;5;4;-1;1;4;0.25
736;5;5;6;5;5;0;2;4;0.50
737;5;5;6;5;6;1;1;4;0.25
738;7;5;6;5;4;-1;1;7;0.14
739;7;5;6;5;5;0;2;7;0.29
740;7;5;6;5;6;1;2;7;0.29
741;7;5;6;5;7;2;2;7;0.29
742;8;5;6;5;4;-1;1;2;0.50
743;8;5;6;5;6;1;1;2;0.50
744;3;6;6;5;4;-1;1;1;1.00
745;7;7;6;5;4;-1;2;2;1.00
746;3;8;6;5;4;-1;1;1;1.00
747;5;8;6;5;4;-1;1;3;0.33
748;5;8;6;5;6;1;1;3;0.33
749;5;8;6;5;7;2;1;3;0.33
750;8;8;6;5;4;-1;1;1;1.00
751;6;2;7;5;4;-1;1;1;1.00
752;3;3;7;5;4;-1;1;1;1.00
753;2;4;7;5;4;-1;1;1;1.00
754;4;4;7;5;4;-1;2;4;0.50
755;4;4;7;5;6;1;1;4;0.25
756;4;4;7;5;8;3;1;4;0.25
757;9;4;7;5;4;-1;1;1;1.00
758;4;6;7;5;4;-1;1;2;0.50
759;4;6;7;5;5;0;1;2;0.50
760;6;6;7;5;4;-1;1;6;0.17
761;6;6;7;5;6;1;3;6;0.50
762;6;6;7;5;7;2;1;6;0.17
763;6;6;7;5;9;4;1;6;0.17
764;7;6;7;5;4;-1;1;4;0.25
765;7;6;7;5;5;0;1;4;0.25
766;7;6;7;5;6;1;2;4;0.50
767;9;6;7;5;4;-1;1;2;0.50
768;9;6;7;5;9;4;1;2;0.50
769;10;6;7;5;4;-1;1;1;1.00
770;4;7;7;5;4;-1;1;2;0.50
771;4;7;7;5;5;0;1;2;0.50
772;8;8;7;5;4;-1;1;1;1.00
773;3;4;8;5;4;-1;1;1;1.00
774;6;5;8;5;4;-1;1;2;0.50
775;6;5;8;5;6;1;1;2;0.50
776;7;5;8;5;4;-1;1;3;0.33
777;7;5;8;5;6;1;2;3;0.67
778;9;7;8;5;4;-1;1;1;1.00
779;7;6;9;5;4;-1;1;2;0.50
780;7;6;9;5;8;3;1;2;0.50
781;3;7;9;5;4;-1;1;1;1.00
782;6;5;10;5;4;-1;1;1;1.00
783;7;6;10;5;4;-1;1;1;1.00
784;3;6;2;6;4;-2;1;1;1.00
785;4;2;3;6;4;-2;1;1;1.00
786;5;3;3;6;4;-2;1;2;0.50
787;5;3;3;6;6;0;1;2;0.50
788;7;3;3;6;4;-2;1;1;1.00
789;6;4;3;6;4;-2;1;2;0.50
790;6;4;3;6;7;1;1;2;0.50
791;2;5;3;6;4;-2;1;1;1.00
792;6;5;3;6;4;-2;2;4;0.50
793;6;5;3;6;5;-1;1;4;0.25
794;6;5;3;6;8;2;1;4;0.25
795;6;6;3;6;4;-2;1;5;0.20
796;6;6;3;6;5;-1;2;5;0.40
797;6;6;3;6;6;0;1;5;0.20
798;6;6;3;6;7;1;1;5;0.20
799;4;7;3;6;4;-2;1;1;1.00
800;8;7;3;6;4;-2;1;2;0.50
801;8;7;3;6;6;0;1;2;0.50
802;6;8;3;6;4;-2;1;2;0.50
803;6;8;3;6;5;-1;1;2;0.50
804;2;3;4;6;4;-2;1;1;1.00
805;4;3;4;6;4;-2;1;1;1.00
806;6;3;4;6;4;-2;1;3;0.33
807;6;3;4;6;5;-1;1;3;0.33
808;6;3;4;6;9;3;1;3;0.33
809;8;3;4;6;4;-2;1;1;1.00
810;7;4;4;6;4;-2;1;7;0.14
811;7;4;4;6;5;-1;2;7;0.29
812;7;4;4;6;6;0;2;7;0.29
813;7;4;4;6;8;2;2;7;0.29
814;2;5;4;6;4;-2;1;1;1.00
815;4;5;4;6;4;-2;1;5;0.20
816;4;5;4;6;5;-1;1;5;0.20
817;4;5;4;6;6;0;1;5;0.20
818;4;5;4;6;7;1;2;5;0.40
819;5;5;4;6;4;-2;1;6;0.17
820;5;5;4;6;6;0;2;6;0.33
821;5;5;4;6;7;1;1;6;0.17
822;5;5;4;6;8;2;1;6;0.17
823;5;5;4;6;9;3;1;6;0.17
824;5;6;4;6;4;-2;1;2;0.50
825;5;6;4;6;6;0;1;2;0.50
826;7;6;4;6;4;-2;1;8;0.12
827;7;6;4;6;6;0;5;8;0.62
828;7;6;4;6;7;1;1;8;0.12
829;7;6;4;6;8;2;1;8;0.12
830;9;6;4;6;4;-2;1;1;1.00
831;7;7;4;6;4;-2;2;3;0.67
832;7;7;4;6;5;-1;1;3;0.33
833;4;9;4;6;4;-2;1;1;1.00
834;5;9;4;6;4;-2;1;1;1.00
835;3;3;5;6;4;-2;1;1;1.00
836;4;4;5;6;4;-2;1;4;0.25
837;4;4;5;6;5;-1;2;4;0.50
838;4;4;5;6;6;0;1;4;0.25
839;8;4;5;6;4;-2;2;2;1.00
840;4;5;5;6;4;-2;1;2;0.50
841;4;5;5;6;7;1;1;2;0.50
842;8;5;5;6;4;-2;1;2;0.50
843;8;5;5;6;5;-1;1;2;0.50
844;5;6;5;6;4;-2;2;9;0.22
845;5;6;5;6;5;-1;3;9;0.33
846;5;6;5;6;6;0;1;9;0.11
847;5;6;5;6;7;1;2;9;0.22
848;5;6;5;6;8;2;1;9;0.11
849;7;6;5;6;4;-2;1;2;0.50
850;7;6;5;6;8;2;1;2;0.50
851;6;7;5;6;4;-2;1;6;0.17
852;6;7;5;6;5;-1;1;6;0.17
853;6;7;5;6;6;0;1;6;0.17
854;6;7;5;6;7;1;2;6;0.33
855;6;7;5;6;9;3;1;6;0.17
856;8;7;5;6;4;-2;2;3;0.67
857;8;7;5;6;5;-1;1;3;0.33
858;3;8;5;6;4;-2;1;1;1.00
859;6;3;6;6;4;-2;1;1;1.00
860;7;3;6;6;4;-2;1;1;1.00
861;7;4;6;6;4;-2;2;7;0.29
862;7;4;6;6;5;-1;2;7;0.29
863;7;4;6;6;6;0;2;7;0.29
864;7;4;6;6;8;2;1;7;0.14
865;8;4;6;6;4;-2;1;4;0.25
866;8;4;6;6;5;-1;3;4;0.75
867;7;5;6;6;4;-2;1;2;0.50
868;7;5;6;6;9;3;1;2;0.50
869;8;5;6;6;4;-2;2;4;0.50
870;8;5;6;6;6;0;2;4;0.50
871;5;6;6;6;4;-2;2;6;0.33
872;5;6;6;6;5;-1;1;6;0.17
873;5;6;6;6;6;0;2;6;0.33
874;5;6;6;6;7;1;1;6;0.17
875;7;3;7;6;4;-2;1;2;0.50
876;7;3;7;6;8;2;1;2;0.50
877;1;4;7;6;4;-2;1;1;1.00
878;4;4;7;6;4;-2;2;3;0.67
879;4;4;7;6;7;1;1;3;0.33
880;7;4;7;6;4;-2;2;2;1.00
881;5;5;7;6;4;-2;2;3;0.67
882;5;5;7;6;7;1;1;3;0.33
883;4;6;7;6;4;-2;1;2;0.50
884;4;6;7;6;6;0;1;2;0.50
885;8;6;7;6;4;-2;1;1;1.00
886;7;7;7;6;4;-2;1;1;1.00
887;5;10;7;6;4;-2;1;1;1.00
888;6;10;7;6;4;-2;1;1;1.00
889;4;4;8;6;4;-2;1;2;0.50
890;4;4;8;6;5;-1;1;2;0.50
891;8;4;8;6;4;-2;1;2;0.50
892;8;4;8;6;9;3;1;2;0.50
893;6;5;8;6;4;-2;1;1;1.00
894;8;7;8;6;4;-2;1;1;1.00
895;6;8;8;6;4;-2;1;1;1.00
896;4;4;9;6;4;-2;1;1;1.00
897;4;9;9;6;4;-2;1;1;1.00
898;5;7;2;7;4;-3;1;1;1.00
899;7;7;2;7;4;-3;1;1;1.00
900;5;3;3;7;4;-3;1;1;1.00
901;6;3;3;7;4;-3;1;2;0.50
902;6;3;3;7;10;3;1;2;0.50
903;2;5;3;7;4;-3;1;1;1.00
904;5;6;3;7;4;-3;1;1;1.00
905;6;6;3;7;4;-3;1;3;0.33
906;6;6;3;7;5;-2;1;3;0.33
907;6;6;3;7;8;1;1;3;0.33
908;6;7;3;7;4;-3;1;1;1.00
909;5;3;4;7;4;-3;1;2;0.50
910;5;3;4;7;5;-2;1;2;0.50
911;7;3;4;7;4;-3;1;1;1.00
912;6;4;4;7;4;-3;1;2;0.50
913;6;4;4;7;5;-2;1;2;0.50
914;7;4;4;7;4;-3;1;2;0.50
915;7;4;4;7;6;-1;1;2;0.50
916;6;5;4;7;4;-3;2;5;0.40
917;6;5;4;7;5;-2;2;5;0.40
918;6;5;4;7;8;1;1;5;0.20
919;7;6;4;7;4;-3;1;2;0.50
920;7;6;4;7;7;0;1;2;0.50
921;5;7;4;7;4;-3;1;2;0.50
922;5;7;4;7;6;-1;1;2;0.50
923;6;7;4;7;4;-3;1;2;0.50
924;6;7;4;7;8;1;1;2;0.50
925;5;8;4;7;4;-3;1;1;1.00
926;4;5;5;7;4;-3;1;2;0.50
927;4;5;5;7;8;1;1;2;0.50
928;3;6;5;7;4;-3;1;1;1.00
929;8;6;5;7;4;-3;1;3;0.33
930;8;6;5;7;7;0;2;3;0.67
931;7;8;5;7;4;-3;1;2;0.50
932;7;8;5;7;5;-2;1;2;0.50
933;6;3;6;7;4;-3;1;2;0.50
934;6;3;6;7;7;0;1;2;0.50
935;5;5;6;7;4;-3;1;8;0.12
936;5;5;6;7;5;-2;1;8;0.12
937;5;5;6;7;6;-1;2;8;0.25
938;5;5;6;7;7;0;3;8;0.38
939;5;5;6;7;8;1;1;8;0.12
940;7;5;6;7;4;-3;1;3;0.33
941;7;5;6;7;5;-2;1;3;0.33
942;7;5;6;7;6;-1;1;3;0.33
943;5;6;6;7;4;-3;1;3;0.33
944;5;6;6;7;7;0;1;3;0.33
945;5;6;6;7;8;1;1;3;0.33
946;6;6;6;7;4;-3;1;5;0.20
947;6;6;6;7;5;-2;1;5;0.20
948;6;6;6;7;6;-1;1;5;0.20
949;6;6;6;7;7;0;2;5;0.40
950;4;7;6;7;4;-3;1;4;0.25
951;4;7;6;7;5;-2;2;4;0.50
952;4;7;6;7;8;1;1;4;0.25
953;7;7;6;7;4;-3;3;3;1.00
954;5;8;6;7;4;-3;1;2;0.50
955;5;8;6;7;5;-2;1;2;0.50
956;5;3;7;7;4;-3;1;1;1.00
957;4;5;7;7;4;-3;2;2;1.00
958;5;5;7;7;4;-3;1;3;0.33
959;5;5;7;7;6;-1;2;3;0.67
960;7;5;7;7;4;-3;1;2;0.50
961;7;5;7;7;6;-1;1;2;0.50
962;5;6;7;7;4;-3;1;7;0.14
963;5;6;7;7;6;-1;3;7;0.43
964;5;6;7;7;7;0;2;7;0.29
965;5;6;7;7;8;1;1;7;0.14
966;2;7;7;7;4;-3;1;1;1.00
967;4;9;7;7;4;-3;1;1;1.00
968;4;5;8;7;4;-3;1;3;0.33
969;4;5;8;7;7;0;1;3;0.33
970;4;5;8;7;8;1;1;3;0.33
971;6;5;8;7;4;-3;1;1;1.00
972;5;6;8;7;4;-3;1;2;0.50
973;5;6;8;7;8;1;1;2;0.50
974;7;6;8;7;4;-3;1;1;1.00
975;6;7;8;7;4;-3;1;3;0.33
976;6;7;8;7;5;-2;1;3;0.33
977;6;7;8;7;8;1;1;3;0.33
978;8;7;8;7;4;-3;1;1;1.00
979;5;6;9;7;4;-3;1;1;1.00
980;7;6;9;7;4;-3;1;1;1.00
981;7;7;9;7;4;-3;1;1;1.00
982;5;6;2;8;4;-4;1;1;1.00
983;8;7;3;8;4;-4;1;1;1.00
984;3;8;3;8;4;-4;1;1;1.00
985;7;8;3;8;4;-4;1;2;0.50
986;7;8;3;8;6;-2;1;2;0.50
987;5;3;4;8;4;-4;1;1;1.00
988;7;3;4;8;4;-4;1;1;1.00
989;3;4;4;8;4;-4;1;1;1.00
990;6;4;4;8;4;-4;1;2;0.50
991;6;4;4;8;6;-2;1;2;0.50
992;7;4;4;8;4;-4;1;1;1.00
993;7;5;4;8;4;-4;2;3;0.67
994;7;5;4;8;6;-2;1;3;0.33
995;5;5;5;8;4;-4;1;2;0.50
996;5;5;5;8;5;-3;1;2;0.50
997;6;5;5;8;4;-4;1;4;0.25
998;6;5;5;8;5;-3;1;4;0.25
999;6;5;5;8;7;-1;2;4;0.50
1000;7;5;5;8;4;-4;1;2;0.50
1001;7;5;5;8;5;-3;1;2;0.50
1002;3;6;5;8;4;-4;1;1;1.00
1003;4;7;5;8;4;-4;1;3;0.33
1004;4;7;5;8;5;-3;1;3;0.33
1005;4;7;5;8;6;-2;1;3;0.33
1006;6;2;6;8;4;-4;1;1;1.00
1007;5;3;6;8;4;-4;1;2;0.50
1008;5;3;6;8;8;0;1;2;0.50
1009;6;3;6;8;4;-4;1;1;1.00
1010;4;5;6;8;4;-4;1;3;0.33
1011;4;5;6;8;6;-2;1;3;0.33
1012;4;5;6;8;7;-1;1;3;0.33
1013;7;5;6;8;4;-4;1;1;1.00
1014;6;6;6;8;4;-4;1;1;1.00
1015;5;8;6;8;4;-4;1;2;0.50
1016;5;8;6;8;5;-3;1;2;0.50
1017;6;3;7;8;4;-4;1;1;1.00
1018;5;5;7;8;4;-4;2;4;0.50
1019;5;5;7;8;6;-2;1;4;0.25
1020;5;5;7;8;7;-1;1;4;0.25
1021;8;5;7;8;4;-4;1;1;1.00
1022;7;6;7;8;4;-4;1;2;0.50
1023;7;6;7;8;5;-3;1;2;0.50
1024;6;7;7;8;4;-4;1;2;0.50
1025;6;7;7;8;7;-1;1;2;0.50
1026;7;8;7;8;4;-4;1;2;0.50
1027;7;8;7;8;6;-2;1;2;0.50
1028;6;3;8;8;4;-4;1;1;1.00
1029;7;7;4;9;4;-5;1;1;1.00
1030;5;8;4;9;4;-5;1;1;1.00
1031;6;4;5;9;4;-5;1;2;0.50
1032;6;4;5;9;5;-4;1;2;0.50
1033;6;5;5;9;4;-5;1;1;1.00
1034;5;6;5;9;4;-5;1;1;1.00
1035;7;6;5;9;4;-5;1;1;1.00
1036;3;7;5;9;4;-5;1;2;0.50
1037;3;7;5;9;6;-3;1;2;0.50
1038;3;4;6;9;4;-5;1;1;1.00
1039;4;8;6;9;4;-5;1;1;1.00
1040;4;7;7;9;4;-5;1;1;1.00
1041;4;8;7;9;4;-5;1;1;1.00
1042;5;8;5;10;4;-6;1;1;1.00
1043;4;6;6;10;4;-6;1;1;1.00
1044;7;3;4;1;5;4;1;1;1.00
1045;5;6;7;1;5;4;1;1;1.00
1046;6;4;4;2;5;3;2;2;1.00
1047;6;5;4;2;5;3;1;1;1.00
1048;7;4;7;2;5;3;1;1;1.00
1049;7;5;7;2;5;3;1;2;0.50
1050;7;5;7;2;7;5;1;2;0.50
1051;6;4;8;2;5;3;1;1;1.00
1052;5;2;9;2;5;3;1;1;1.00
1053;4;7;2;3;5;2;1;1;1.00
1054;5;5;3;3;5;2;1;3;0.33
1055;5;5;3;3;6;3;1;3;0.33
1056;5;5;3;3;7;4;1;3;0.33
1057;6;6;3;3;5;2;1;1;1.00
1058;9;6;3;3;5;2;1;1;1.00
1059;6;9;3;3;5;2;1;1;1.00
1060;5;4;4;3;5;2;1;1;1.00
1061;6;4;4;3;5;2;1;1;1.00
1062;2;5;4;3;5;2;1;1;1.00
1063;7;5;4;3;5;2;1;1;1.00
1064;2;7;4;3;5;2;1;1;1.00
1065;4;7;4;3;5;2;1;1;1.00
1066;6;7;4;3;5;2;1;1;1.00
1067;7;8;4;3;5;2;2;2;1.00
1068;3;3;5;3;5;2;1;1;1.00
1069;4;3;5;3;5;2;1;2;0.50
1070;4;3;5;3;8;5;1;2;0.50
1071;7;4;5;3;5;2;1;2;0.50
1072;7;4;5;3;6;3;1;2;0.50
1073;6;7;5;3;5;2;1;1;1.00
1074;8;7;5;3;5;2;1;2;0.50
1075;8;7;5;3;6;3;1;2;0.50
1076;9;7;5;3;5;2;1;2;0.50
1077;9;7;5;3;8;5;1;2;0.50
1078;6;8;5;3;5;2;1;1;1.00
1079;8;9;5;3;5;2;1;1;1.00
1080;3;4;6;3;5;2;1;1;1.00
1081;5;4;6;3;5;2;1;2;0.50
1082;5;4;6;3;7;4;1;2;0.50
1083;7;4;6;3;5;2;1;1;1.00
1084;8;4;6;3;5;2;1;1;1.00
1085;7;5;6;3;5;2;1;1;1.00
1086;8;5;6;3;5;2;1;2;0.50
1087;8;5;6;3;7;4;1;2;0.50
1088;6;8;6;3;5;2;1;1;1.00
1089;5;6;7;3;5;2;2;2;1.00
1090;6;3;8;3;5;2;1;1;1.00
1091;5;5;8;3;5;2;1;1;1.00
1092;9;3;2;4;5;1;1;1;1.00
1093;7;4;2;4;5;1;1;1;1.00
1094;6;4;3;4;5;1;1;1;1.00
1095;9;5;3;4;5;1;1;1;1.00
1096;9;6;3;4;5;1;1;1;1.00
1097;9;8;3;4;5;1;1;1;1.00
1098;4;4;4;4;5;1;1;1;1.00
1099;5;4;4;4;5;1;1;3;0.33
1100;5;4;4;4;7;3;1;3;0.33
1101;5;4;4;4;8;4;1;3;0.33
1102;6;4;4;4;5;1;1;2;0.50
1103;6;4;4;4;7;3;1;2;0.50
1104;4;5;4;4;5;1;1;1;1.00
1105;5;3;5;4;5;1;1;1;1.00
1106;6;4;5;4;5;1;1;4;0.25
1107;6;4;5;4;6;2;2;4;0.50
1108;6;4;5;4;7;3;1;4;0.25
1109;3;5;5;4;5;1;1;1;1.00
1110;6;5;5;4;5;1;1;2;0.50
1111;6;5;5;4;7;3;1;2;0.50
1112;4;6;5;4;5;1;2;2;1.00
1113;6;6;5;4;5;1;1;1;1.00
1114;7;6;5;4;5;1;1;2;0.50
1115;7;6;5;4;7;3;1;2;0.50
1116;8;7;5;4;5;1;1;1;1.00
1117;5;10;5;4;5;1;1;1;1.00
1118;3;3;6;4;5;1;1;2;0.50
1119;3;3;6;4;7;3;1;2;0.50
1120;4;3;6;4;5;1;1;1;1.00
1121;5;3;6;4;5;1;1;3;0.33
1122;5;3;6;4;6;2;2;3;0.67
1123;4;4;6;4;5;1;1;1;1.00
1124;3;5;6;4;5;1;1;1;1.00
1125;3;6;6;4;5;1;1;2;0.50
1126;3;6;6;4;7;3;1;2;0.50
1127;6;6;6;4;5;1;1;2;0.50
1128;6;6;6;4;6;2;1;2;0.50
1129;3;7;6;4;5;1;1;1;1.00
1130;5;7;6;4;5;1;1;3;0.33
1131;5;7;6;4;6;2;1;3;0.33
1132;5;7;6;4;7;3;1;3;0.33
1133;10;7;6;4;5;1;2;2;1.00
1134;4;8;6;4;5;1;2;2;1.00
1135;6;9;6;4;5;1;1;1;1.00
1136;7;4;7;4;5;1;1;2;0.50
1137;7;4;7;4;6;2;1;2;0.50
1138;8;5;7;4;5;1;1;2;0.50
1139;8;5;7;4;8;4;1;2;0.50
1140;3;6;7;4;5;1;1;1;1.00
1141;6;6;7;4;5;1;2;5;0.40
1142;6;6;7;4;6;2;1;5;0.20
1143;6;6;7;4;7;3;2;5;0.40
1144;7;6;7;4;5;1;2;4;0.50
1145;7;6;7;4;6;2;2;4;0.50
1146;7;9;7;4;5;1;1;1;1.00
1147;6;5;8;4;5;1;1;2;0.50
1148;6;5;8;4;6;2;1;2;0.50
1149;2;6;8;4;5;1;1;1;1.00
1150;5;6;8;4;5;1;1;2;0.50
1151;5;6;8;4;6;2;1;2;0.50
1152;7;7;8;4;5;1;1;1;1.00
1153;7;5;9;4;5;1;1;1;1.00
1154;4;6;9;4;5;1;1;1;1.00
1155;8;5;10;4;5;1;1;1;1.00
1156;3;4;1;5;5;0;1;1;1.00
1157;2;9;2;5;5;0;1;1;1.00
1158;5;3;3;5;5;0;1;1;1.00
1159;6;4;3;5;5;0;2;3;0.67
1160;6;4;3;5;8;3;1;3;0.33
1161;4;5;3;5;5;0;1;1;1.00
1162;5;5;3;5;5;0;1;1;1.00
1163;8;5;3;5;5;0;1;1;1.00
1164;4;3;4;5;5;0;1;1;1.00
1165;4;4;4;5;5;0;1;3;0.33
1166;4;4;4;5;6;1;2;3;0.67
1167;5;4;4;5;5;0;1;2;0.50
1168;5;4;4;5;6;1;1;2;0.50
1169;3;5;4;5;5;0;1;2;0.50
1170;3;5;4;5;6;1;1;2;0.50
1171;5;5;4;5;5;0;1;3;0.33
1172;5;5;4;5;6;1;1;3;0.33
1173;5;5;4;5;8;3;1;3;0.33
1174;7;5;4;5;5;0;2;3;0.67
1175;7;5;4;5;8;3;1;3;0.33
1176;3;6;4;5;5;0;2;3;0.67
1177;3;6;4;5;6;1;1;3;0.33
1178;8;7;4;5;5;0;1;1;1.00
1179;9;2;5;5;5;0;1;1;1.00
1180;3;3;5;5;5;0;1;1;1.00
1181;5;3;5;5;5;0;2;3;0.67
1182;5;3;5;5;8;3;1;3;0.33
1183;4;5;5;5;5;0;1;4;0.25
1184;4;5;5;5;6;1;1;4;0.25
1185;4;5;5;5;7;2;2;4;0.50
1186;7;5;5;5;5;0;1;7;0.14
1187;7;5;5;5;6;1;3;7;0.43
1188;7;5;5;5;7;2;2;7;0.29
1189;7;5;5;5;9;4;1;7;0.14
1190;9;5;5;5;5;0;1;4;0.25
1191;9;5;5;5;6;1;1;4;0.25
1192;9;5;5;5;7;2;1;4;0.25
1193;9;5;5;5;8;3;1;4;0.25
1194;7;6;5;5;5;0;2;2;1.00
1195;8;7;5;5;5;0;2;2;1.00
1196;7;8;5;5;5;0;2;3;0.67
1197;7;8;5;5;6;1;1;3;0.33
1198;2;9;5;5;5;0;1;1;1.00
1199;4;9;5;5;5;0;1;1;1.00
1200;5;2;6;5;5;0;1;2;0.50
1201;5;2;6;5;7;2;1;2;0.50
1202;5;3;6;5;5;0;1;2;0.50
1203;5;3;6;5;8;3;1;2;0.50
1204;8;3;6;5;5;0;1;2;0.50
1205;8;3;6;5;6;1;1;2;0.50
1206;4;5;6;5;5;0;1;4;0.25
1207;4;5;6;5;6;1;1;4;0.25
1208;4;5;6;5;7;2;1;4;0.25
1209;4;5;6;5;9;4;1;4;0.25
1210;1;6;6;5;5;0;1;1;1.00
1211;4;6;6;5;5;0;3;11;0.27
1212;4;6;6;5;6;1;3;11;0.27
1213;4;6;6;5;7;2;2;11;0.18
1214;4;6;6;5;8;3;2;11;0.18
1215;4;6;6;5;9;4;1;11;0.09
1216;6;6;6;5;5;0;2;5;0.40
1217;6;6;6;5;7;2;1;5;0.20
1218;6;6;6;5;8;3;2;5;0.40
1219;7;6;6;5;5;0;4;5;0.80
1220;7;6;6;5;10;5;1;5;0.20
1221;8;6;6;5;5;0;1;1;1.00
1222;5;7;6;5;5;0;1;4;0.25
1223;5;7;6;5;7;2;1;4;0.25
1224;5;7;6;5;8;3;2;4;0.50
1225;6;7;6;5;5;0;1;2;0.50
1226;6;7;6;5;6;1;1;2;0.50
1227;5;4;7;5;5;0;1;3;0.33
1228;5;4;7;5;7;2;1;3;0.33
1229;5;4;7;5;8;3;1;3;0.33
1230;8;4;7;5;5;0;2;3;0.67
1231;8;4;7;5;6;1;1;3;0.33
1232;3;5;7;5;5;0;2;3;0.67
1233;3;5;7;5;7;2;1;3;0.33
1234;4;5;7;5;5;0;1;2;0.50
1235;4;5;7;5;7;2;1;2;0.50
1236;5;5;7;5;5;0;2;2;1.00
1237;6;5;7;5;5;0;2;5;0.40
1238;6;5;7;5;6;1;3;5;0.60
1239;2;6;7;5;5;0;1;1;1.00
1240;3;6;7;5;5;0;1;1;1.00
1241;7;7;7;5;5;0;1;2;0.50
1242;7;7;7;5;7;2;1;2;0.50
1243;8;4;8;5;5;0;1;1;1.00
1244;4;5;8;5;5;0;1;1;1.00
1245;4;6;8;5;5;0;1;2;0.50
1246;4;6;8;5;6;1;1;2;0.50
1247;2;7;8;5;5;0;1;1;1.00
1248;5;7;8;5;5;0;1;1;1.00
1249;8;7;8;5;5;0;1;1;1.00
1250;4;9;8;5;5;0;1;1;1.00
1251;6;2;9;5;5;0;1;1;1.00
1252;4;4;9;5;5;0;1;1;1.00
1253;4;5;9;5;5;0;1;1;1.00
1254;6;5;9;5;5;0;2;2;1.00
1255;8;5;9;5;5;0;1;1;1.00
1256;4;6;9;5;5;0;1;2;0.50
1257;4;6;9;5;6;1;1;2;0.50
1258;5;6;9;5;5;0;1;1;1.00
1259;8;5;10;5;5;0;1;1;1.00
1260;7;7;1;6;5;-1;1;1;1.00
1261;6;5;2;6;5;-1;1;1;1.00
1262;7;5;2;6;5;-1;1;1;1.00
1263;5;2;3;6;5;-1;1;1;1.00
1264;2;3;3;6;5;-1;1;1;1.00
1265;7;4;3;6;5;-1;1;1;1.00
1266;4;5;3;6;5;-1;1;3;0.33
1267;4;5;3;6;6;0;1;3;0.33
1268;4;5;3;6;8;2;1;3;0.33
1269;7;6;3;6;5;-1;2;2;1.00
1270;8;8;3;6;5;-1;1;1;1.00
1271;5;3;4;6;5;-1;1;1;1.00
1272;3;4;4;6;5;-1;1;2;0.50
1273;3;4;4;6;6;0;1;2;0.50
1274;5;4;4;6;5;-1;1;2;0.50
1275;5;4;4;6;6;0;1;2;0.50
1276;6;4;4;6;5;-1;1;2;0.50
1277;6;4;4;6;6;0;1;2;0.50
1278;3;6;4;6;5;-1;1;4;0.25
1279;3;6;4;6;6;0;2;4;0.50
1280;3;6;4;6;8;2;1;4;0.25
1281;3;7;4;6;5;-1;1;4;0.25
1282;3;7;4;6;6;0;1;4;0.25
1283;3;7;4;6;7;1;1;4;0.25
1284;3;7;4;6;8;2;1;4;0.25
1285;6;7;4;6;5;-1;3;6;0.50
1286;6;7;4;6;6;0;2;6;0.33
1287;6;7;4;6;9;3;1;6;0.17
1288;6;8;4;6;5;-1;2;4;0.50
1289;6;8;4;6;6;0;2;4;0.50
1290;4;3;5;6;5;-1;1;3;0.33
1291;4;3;5;6;6;0;1;3;0.33
1292;4;3;5;6;7;1;1;3;0.33
1293;5;3;5;6;5;-1;3;5;0.60
1294;5;3;5;6;7;1;1;5;0.20
1295;5;3;5;6;9;3;1;5;0.20
1296;6;3;5;6;5;-1;1;3;0.33
1297;6;3;5;6;7;1;2;3;0.67
1298;8;3;5;6;5;-1;1;2;0.50
1299;8;3;5;6;7;1;1;2;0.50
1300;6;4;5;6;5;-1;2;5;0.40
1301;6;4;5;6;6;0;1;5;0.20
1302;6;4;5;6;7;1;1;5;0.20
1303;6;4;5;6;8;2;1;5;0.20
1304;7;5;5;6;5;-1;1;2;0.50
1305;7;5;5;6;6;0;1;2;0.50
1306;3;6;5;6;5;-1;1;4;0.25
1307;3;6;5;6;6;0;1;4;0.25
1308;3;6;5;6;7;1;1;4;0.25
1309;3;6;5;6;9;3;1;4;0.25
1310;6;6;5;6;5;-1;1;3;0.33
1311;6;6;5;6;6;0;1;3;0.33
1312;6;6;5;6;8;2;1;3;0.33
1313;4;7;5;6;5;-1;2;4;0.50
1314;4;7;5;6;6;0;1;4;0.25
1315;4;7;5;6;7;1;1;4;0.25
1316;4;8;5;6;5;-1;1;1;1.00
1317;6;9;5;6;5;-1;1;1;1.00
1318;7;1;6;6;5;-1;1;1;1.00
1319;5;3;6;6;5;-1;1;2;0.50
1320;5;3;6;6;7;1;1;2;0.50
1321;2;4;6;6;5;-1;2;3;0.67
1322;2;4;6;6;7;1;1;3;0.33
1323;5;4;6;6;5;-1;1;7;0.14
1324;5;4;6;6;6;0;3;7;0.43
1325;5;4;6;6;7;1;2;7;0.29
1326;5;4;6;6;8;2;1;7;0.14
1327;3;5;6;6;5;-1;1;1;1.00
1328;3;7;6;6;5;-1;2;4;0.50
1329;3;7;6;6;6;0;1;4;0.25
1330;3;7;6;6;8;2;1;4;0.25
1331;7;7;6;6;5;-1;1;1;1.00
1332;9;7;6;6;5;-1;1;1;1.00
1333;7;8;6;6;5;-1;1;1;1.00
1334;5;2;7;6;5;-1;1;1;1.00
1335;3;4;7;6;5;-1;2;3;0.67
1336;3;4;7;6;8;2;1;3;0.33
1337;6;4;7;6;5;-1;1;2;0.50
1338;6;4;7;6;8;2;1;2;0.50
1339;1;5;7;6;5;-1;1;1;1.00
1340;3;5;7;6;5;-1;3;3;1.00
1341;7;6;7;6;5;-1;1;2;0.50
1342;7;6;7;6;6;0;1;2;0.50
1343;5;3;8;6;5;-1;1;1;1.00
1344;5;4;8;6;5;-1;1;1;1.00
1345;7;4;8;6;5;-1;1;2;0.50
1346;7;4;8;6;6;0;1;2;0.50
1347;3;5;8;6;5;-1;2;4;0.50
1348;3;5;8;6;7;1;1;4;0.25
1349;3;5;8;6;8;2;1;4;0.25
1350;7;5;8;6;5;-1;1;2;0.50
1351;7;5;8;6;8;2;1;2;0.50
1352;4;8;8;6;5;-1;1;1;1.00
1353;7;5;9;6;5;-1;1;1;1.00
1354;6;8;9;6;5;-1;1;1;1.00
1355;4;6;10;6;5;-1;1;1;1.00
1356;3;7;10;6;5;-1;1;1;1.00
1357;6;6;2;7;5;-2;1;1;1.00
1358;6;4;3;7;5;-2;1;1;1.00
1359;9;6;3;7;5;-2;1;1;1.00
1360;6;8;3;7;5;-2;1;1;1.00
1361;7;8;3;7;5;-2;1;1;1.00
1362;6;2;4;7;5;-2;1;1;1.00
1363;4;4;4;7;5;-2;1;2;0.50
1364;4;4;4;7;6;-1;1;2;0.50
1365;5;4;4;7;5;-2;1;2;0.50
1366;5;4;4;7;6;-1;1;2;0.50
1367;8;4;4;7;5;-2;1;1;1.00
1368;4;5;4;7;5;-2;1;2;0.50
1369;4;5;4;7;6;-1;1;2;0.50
1370;3;6;4;7;5;-2;1;1;1.00
1371;4;7;4;7;5;-2;1;3;0.33
1372;4;7;4;7;7;0;1;3;0.33
1373;4;7;4;7;8;1;1;3;0.33
1374;3;8;4;7;5;-2;1;2;0.50
1375;3;8;4;7;6;-1;1;2;0.50
1376;7;8;4;7;5;-2;1;1;1.00
1377;8;8;4;7;5;-2;1;1;1.00
1378;4;9;4;7;5;-2;1;1;1.00
1379;4;3;5;7;5;-2;1;1;1.00
1380;8;3;5;7;5;-2;1;1;1.00
1381;3;4;5;7;5;-2;1;1;1.00
1382;6;5;5;7;5;-2;1;3;0.33
1383;6;5;5;7;6;-1;1;3;0.33
1384;6;5;5;7;8;1;1;3;0.33
1385;8;5;5;7;5;-2;1;1;1.00
1386;7;6;5;7;5;-2;2;4;0.50
1387;7;6;5;7;6;-1;1;4;0.25
1388;7;6;5;7;8;1;1;4;0.25
1389;10;6;5;7;5;-2;1;1;1.00
1390;3;7;5;7;5;-2;1;2;0.50
1391;3;7;5;7;7;0;1;2;0.50
1392;7;7;5;7;5;-2;3;4;0.75
1393;7;7;5;7;6;-1;1;4;0.25
1394;3;8;5;7;5;-2;1;2;0.50
1395;3;8;5;7;8;1;1;2;0.50
1396;5;9;5;7;5;-2;1;1;1.00
1397;8;9;5;7;5;-2;1;1;1.00
1398;5;2;6;7;5;-2;1;1;1.00
1399;7;3;6;7;5;-2;1;1;1.00
1400;2;4;6;7;5;-2;1;1;1.00
1401;7;4;6;7;5;-2;1;2;0.50
1402;7;4;6;7;8;1;1;2;0.50
1403;6;5;6;7;5;-2;2;6;0.33
1404;6;5;6;7;6;-1;2;6;0.33
1405;6;5;6;7;7;0;2;6;0.33
1406;1;6;6;7;5;-2;1;1;1.00
1407;7;6;6;7;5;-2;1;1;1.00
1408;6;7;6;7;5;-2;2;2;1.00
1409;6;8;6;7;5;-2;1;3;0.33
1410;6;8;6;7;6;-1;1;3;0.33
1411;6;8;6;7;7;0;1;3;0.33
1412;8;8;6;7;5;-2;1;1;1.00
1413;2;9;6;7;5;-2;1;1;1.00
1414;3;9;6;7;5;-2;1;1;1.00
1415;5;10;6;7;5;-2;1;1;1.00
1416;2;2;7;7;5;-2;1;1;1.00
1417;6;3;7;7;5;-2;1;1;1.00
1418;6;4;7;7;5;-2;1;4;0.25
1419;6;4;7;7;6;-1;2;4;0.50
1420;6;4;7;7;7;0;1;4;0.25
1421;7;4;7;7;5;-2;1;1;1.00
1422;3;5;7;7;5;-2;1;2;0.50
1423;3;5;7;7;6;-1;1;2;0.50
1424;6;6;7;7;5;-2;1;3;0.33
1425;6;6;7;7;6;-1;1;3;0.33
1426;6;6;7;7;8;1;1;3;0.33
1427;8;6;7;7;5;-2;1;1;1.00
1428;4;7;7;7;5;-2;1;2;0.50
1429;4;7;7;7;6;-1;1;2;0.50
1430;5;8;7;7;5;-2;1;1;1.00
1431;5;4;8;7;5;-2;1;1;1.00
1432;7;4;8;7;5;-2;1;1;1.00
1433;9;4;8;7;5;-2;1;1;1.00
1434;9;5;8;7;5;-2;1;1;1.00
1435;4;7;8;7;5;-2;1;2;0.50
1436;4;7;8;7;8;1;1;2;0.50
1437;5;7;8;7;5;-2;2;2;1.00
1438;8;8;8;7;5;-2;1;1;1.00
1439;7;5;9;7;5;-2;1;2;0.50
1440;7;5;9;7;8;1;1;2;0.50
1441;4;6;9;7;5;-2;1;1;1.00
1442;4;4;10;7;5;-2;1;1;1.00
1443;3;5;2;8;5;-3;1;1;1.00
1444;8;4;3;8;5;-3;1;1;1.00
1445;7;5;3;8;5;-3;1;1;1.00
1446;8;3;4;8;5;-3;1;2;0.50
1447;8;3;4;8;8;0;1;2;0.50
1448;4;6;4;8;5;-3;1;1;1.00
1449;4;8;4;8;5;-3;1;2;0.50
1450;4;8;4;8;7;-1;1;2;0.50
1451;8;2;5;8;5;-3;1;1;1.00
1452;5;4;5;8;5;-3;1;4;0.25
1453;5;4;5;8;7;-1;2;4;0.50
1454;5;4;5;8;8;0;1;4;0.25
1455;4;5;5;8;5;-3;1;2;0.50
1456;4;5;5;8;6;-2;1;2;0.50
1457;10;6;5;8;5;-3;1;1;1.00
1458;6;7;5;8;5;-3;1;1;1.00
1459;7;7;5;8;5;-3;1;1;1.00
1460;8;4;6;8;5;-3;1;1;1.00
1461;3;7;6;8;5;-3;1;1;1.00
1462;3;2;7;8;5;-3;1;1;1.00
1463;7;5;7;8;5;-3;1;1;1.00
1464;6;6;7;8;5;-3;1;2;0.50
1465;6;6;7;8;7;-1;1;2;0.50
1466;4;7;7;8;5;-3;1;1;1.00
1467;5;8;7;8;5;-3;1;1;1.00
1468;5;9;7;8;5;-3;1;1;1.00
1469;2;4;8;8;5;-3;1;1;1.00
1470;3;6;8;8;5;-3;1;1;1.00
1471;8;6;8;8;5;-3;1;1;1.00
1472;8;4;9;8;5;-3;1;1;1.00
1473;6;6;2;9;5;-4;1;1;1.00
1474;5;4;4;9;5;-4;1;2;0.50
1475;5;4;4;9;6;-3;1;2;0.50
1476;3;8;4;9;5;-4;1;1;1.00
1477;4;3;5;9;5;-4;1;1;1.00
1478;5;5;5;9;5;-4;1;1;1.00
1479;4;6;5;9;5;-4;1;1;1.00
1480;6;6;5;9;5;-4;1;1;1.00
1481;6;7;5;9;5;-4;1;2;0.50
1482;6;7;5;9;7;-2;1;2;0.50
1483;8;8;5;9;5;-4;1;1;1.00
1484;7;4;6;9;5;-4;1;1;1.00
1485;3;5;6;9;5;-4;1;1;1.00
1486;6;7;6;9;5;-4;1;1;1.00
1487;7;7;6;9;5;-4;1;2;0.50
1488;7;7;6;9;6;-3;1;2;0.50
1489;4;3;7;9;5;-4;1;1;1.00
1490;4;6;7;9;5;-4;1;1;1.00
1491;5;6;8;9;5;-4;1;1;1.00
1492;6;6;8;9;5;-4;1;1;1.00
1493;6;6;5;10;5;-5;1;1;1.00
1494;6;8;5;10;5;-5;1;1;1.00
1495;7;7;6;10;5;-5;1;1;1.00
1496;4;6;6;1;6;5;1;1;1.00
1497;6;4;7;1;6;5;1;1;1.00
1498;6;7;7;1;6;5;1;1;1.00
1499;4;7;8;1;6;5;1;1;1.00
1500;7;5;5;2;6;4;1;1;1.00
1501;5;6;5;2;6;4;1;1;1.00
1502;6;7;5;2;6;4;1;1;1.00
1503;4;3;6;2;6;4;1;1;1.00
1504;3;4;6;2;6;4;1;1;1.00
1505;3;6;6;2;6;4;1;1;1.00
1506;5;4;1;3;6;3;1;1;1.00
1507;8;4;2;3;6;3;1;1;1.00
1508;4;5;2;3;6;3;1;1;1.00
1509;5;2;3;3;6;3;1;1;1.00
1510;6;5;3;3;6;3;1;1;1.00
1511;5;7;3;3;6;3;1;1;1.00
1512;7;3;4;3;6;3;1;1;1.00
1513;4;5;4;3;6;3;1;1;1.00
1514;7;2;5;3;6;3;1;1;1.00
1515;6;4;5;3;6;3;2;2;1.00
1516;4;6;5;3;6;3;1;1;1.00
1517;6;6;5;3;6;3;1;1;1.00
1518;9;6;5;3;6;3;2;2;1.00
1519;4;6;6;3;6;3;1;1;1.00
1520;3;7;6;3;6;3;1;1;1.00
1521;4;7;6;3;6;3;1;1;1.00
1522;7;4;7;3;6;3;1;1;1.00
1523;7;7;7;3;6;3;1;1;1.00
1524;6;8;7;3;6;3;1;1;1.00
1525;7;8;7;3;6;3;1;1;1.00
1526;6;5;8;3;6;3;2;2;1.00
1527;4;8;8;3;6;3;1;1;1.00
1528;5;7;9;3;6;3;1;1;1.00
1529;4;4;2;4;6;2;1;1;1.00
1530;9;4;2;4;6;2;1;1;1.00
1531;5;5;2;4;6;2;1;1;1.00
1532;6;5;2;4;6;2;1;1;1.00
1533;6;2;3;4;6;2;1;1;1.00
1534;7;3;3;4;6;2;1;1;1.00
1535;8;3;3;4;6;2;1;1;1.00
1536;7;5;3;4;6;2;1;2;0.50
1537;7;5;3;4;8;4;1;2;0.50
1538;5;6;3;4;6;2;1;1;1.00
1539;6;6;3;4;6;2;2;2;1.00
1540;7;3;4;4;6;2;1;2;0.50
1541;7;3;4;4;10;6;1;2;0.50
1542;8;3;4;4;6;2;1;1;1.00
1543;6;6;4;4;6;2;2;3;0.67
1544;6;6;4;4;8;4;1;3;0.33
1545;3;7;4;4;6;2;1;1;1.00
1546;5;7;4;4;6;2;2;3;0.67
1547;5;7;4;4;7;3;1;3;0.33
1548;6;7;4;4;6;2;1;2;0.50
1549;6;7;4;4;7;3;1;2;0.50
1550;8;7;4;4;6;2;2;2;1.00
1551;5;9;4;4;6;2;1;2;0.50
1552;5;9;4;4;7;3;1;2;0.50
1553;7;2;5;4;6;2;1;1;1.00
1554;5;4;5;4;6;2;1;2;0.50
1555;5;4;5;4;7;3;1;2;0.50
1556;4;5;5;4;6;2;2;3;0.67
1557;4;5;5;4;7;3;1;3;0.33
1558;8;6;5;4;6;2;1;3;0.33
1559;8;6;5;4;7;3;1;3;0.33
1560;8;6;5;4;8;4;1;3;0.33
1561;4;8;5;4;6;2;1;1;1.00
1562;7;9;5;4;6;2;1;1;1.00
1563;6;10;5;4;6;2;1;1;1.00
1564;6;2;6;4;6;2;1;1;1.00
1565;2;3;6;4;6;2;1;1;1.00
1566;7;6;6;4;6;2;1;1;1.00
1567;4;7;6;4;6;2;4;5;0.80
1568;4;7;6;4;7;3;1;5;0.20
1569;7;7;6;4;6;2;1;1;1.00
1570;5;8;6;4;6;2;1;1;1.00
1571;9;9;6;4;6;2;1;1;1.00
1572;4;4;7;4;6;2;1;2;0.50
1573;4;4;7;4;7;3;1;2;0.50
1574;5;4;7;4;6;2;1;2;0.50
1575;5;4;7;4;7;3;1;2;0.50
1576;6;4;7;4;6;2;2;3;0.67
1577;6;4;7;4;7;3;1;3;0.33
1578;4;6;7;4;6;2;1;1;1.00
1579;9;7;7;4;6;2;1;1;1.00
1580;6;9;7;4;6;2;1;2;0.50
1581;6;9;7;4;7;3;1;2;0.50
1582;3;4;8;4;6;2;1;2;0.50
1583;3;4;8;4;8;4;1;2;0.50
1584;4;6;8;4;6;2;1;1;1.00
1585;8;4;9;4;6;2;1;1;1.00
1586;5;5;9;4;6;2;1;1;1.00
1587;8;6;9;4;6;2;1;1;1.00
1588;7;7;9;4;6;2;1;1;1.00
1589;6;3;3;5;6;1;1;2;0.50
1590;6;3;3;5;7;2;1;2;0.50
1591;6;5;3;5;6;1;1;1;1.00
1592;7;5;3;5;6;1;2;3;0.67
1593;7;5;3;5;7;2;1;3;0.33
1594;9;5;3;5;6;1;1;1;1.00
1595;8;6;3;5;6;1;1;1;1.00
1596;5;8;3;5;6;1;1;1;1.00
1597;6;8;3;5;6;1;1;1;1.00
1598;3;2;4;5;6;1;1;1;1.00
1599;4;2;4;5;6;1;1;1;1.00
1600;6;3;4;5;6;1;1;1;1.00
1601;8;3;4;5;6;1;1;1;1.00
1602;6;4;4;5;6;1;1;1;1.00
1603;9;6;4;5;6;1;1;1;1.00
1604;5;8;4;5;6;1;1;1;1.00
1605;6;8;4;5;6;1;1;2;0.50
1606;6;8;4;5;7;2;1;2;0.50
1607;5;9;4;5;6;1;1;1;1.00
1608;5;10;4;5;6;1;1;1;1.00
1609;7;3;5;5;6;1;1;1;1.00
1610;3;5;5;5;6;1;2;4;0.50
1611;3;5;5;5;7;2;2;4;0.50
1612;8;5;5;5;6;1;1;2;0.50
1613;8;5;5;5;7;2;1;2;0.50
1614;3;6;5;5;6;1;1;2;0.50
1615;3;6;5;5;7;2;1;2;0.50
1616;4;8;5;5;6;1;1;1;1.00
1617;5;10;5;5;6;1;1;1;1.00
1618;5;4;6;5;6;1;1;1;1.00
1619;8;4;6;5;6;1;1;2;0.50
1620;8;4;6;5;9;4;1;2;0.50
1621;9;5;6;5;6;1;1;1;1.00
1622;4;7;6;5;6;1;1;4;0.25
1623;4;7;6;5;7;2;3;4;0.75
1624;8;3;7;5;6;1;1;2;0.50
1625;8;3;7;5;9;4;1;2;0.50
1626;3;4;7;5;6;1;1;1;1.00
1627;2;7;7;5;6;1;1;1;1.00
1628;5;8;7;5;6;1;2;2;1.00
1629;5;2;8;5;6;1;1;1;1.00
1630;5;3;8;5;6;1;1;1;1.00
1631;6;4;8;5;6;1;1;1;1.00
1632;4;7;8;5;6;1;1;1;1.00
1633;4;8;8;5;6;1;1;1;1.00
1634;6;8;8;5;6;1;1;2;0.50
1635;6;8;8;5;9;4;1;2;0.50
1636;3;5;9;5;6;1;1;1;1.00
1637;5;5;9;5;6;1;1;1;1.00
1638;6;7;9;5;6;1;1;1;1.00
1639;6;6;1;6;6;0;1;1;1.00
1640;4;7;1;6;6;0;1;1;1.00
1641;7;8;1;6;6;0;1;1;1.00
1642;4;1;3;6;6;0;1;1;1.00
1643;3;4;3;6;6;0;1;1;1.00
1644;7;5;3;6;6;0;1;1;1.00
1645;5;8;3;6;6;0;1;2;0.50
1646;5;8;3;6;7;1;1;2;0.50
1647;4;2;4;6;6;0;2;2;1.00
1648;5;2;4;6;6;0;1;2;0.50
1649;5;2;4;6;7;1;1;2;0.50
1650;9;4;4;6;6;0;1;1;1.00
1651;7;5;4;6;6;0;2;3;0.67
1652;7;5;4;6;9;3;1;3;0.33
1653;9;5;4;6;6;0;1;1;1.00
1654;2;7;4;6;6;0;1;1;1.00
1655;5;8;4;6;6;0;1;2;0.50
1656;5;8;4;6;8;2;1;2;0.50
1657;7;8;4;6;6;0;1;1;1.00
1658;4;2;5;6;6;0;1;1;1.00
1659;3;4;5;6;6;0;1;2;0.50
1660;3;4;5;6;8;2;1;2;0.50
1661;9;4;5;6;6;0;1;1;1.00
1662;3;5;5;6;6;0;1;2;0.50
1663;3;5;5;6;7;1;1;2;0.50
1664;8;6;5;6;6;0;1;1;1.00
1665;2;8;5;6;6;0;1;1;1.00
1666;8;8;5;6;6;0;2;2;1.00
1667;5;9;5;6;6;0;1;2;0.50
1668;5;9;5;6;7;1;1;2;0.50
1669;7;9;5;6;6;0;1;1;1.00
1670;6;1;6;6;6;0;1;1;1.00
1671;3;4;6;6;6;0;1;1;1.00
1672;3;8;6;6;6;0;1;1;1.00
1673;6;3;7;6;6;0;1;1;1.00
1674;8;3;7;6;6;0;1;1;1.00
1675;7;5;7;6;6;0;2;3;0.67
1676;7;5;7;6;7;1;1;3;0.33
1677;7;9;7;6;6;0;1;1;1.00
1678;4;2;8;6;6;0;1;1;1.00
1679;8;3;8;6;6;0;1;1;1.00
1680;8;5;8;6;6;0;1;1;1.00
1681;6;6;8;6;6;0;1;1;1.00
1682;5;7;8;6;6;0;1;1;1.00
1683;5;5;2;7;6;-1;1;1;1.00
1684;6;7;2;7;6;-1;1;1;1.00
1685;6;5;3;7;6;-1;1;1;1.00
1686;7;5;3;7;6;-1;2;2;1.00
1687;4;6;3;7;6;-1;1;1;1.00
1688;5;7;3;7;6;-1;1;2;0.50
1689;5;7;3;7;7;0;1;2;0.50
1690;7;7;3;7;6;-1;1;2;0.50
1691;7;7;3;7;7;0;1;2;0.50
1692;4;8;3;7;6;-1;1;1;1.00
1693;5;1;4;7;6;-1;1;1;1.00
1694;2;3;4;7;6;-1;2;2;1.00
1695;3;3;4;7;6;-1;1;1;1.00
1696;5;5;4;7;6;-1;1;2;0.50
1697;5;5;4;7;7;0;1;2;0.50
1698;8;6;4;7;6;-1;1;2;0.50
1699;8;6;4;7;7;0;1;2;0.50
1700;8;7;4;7;6;-1;1;2;0.50
1701;8;7;4;7;8;1;1;2;0.50
1702;2;8;4;7;6;-1;1;1;1.00
1703;6;10;4;7;6;-1;1;1;1.00
1704;7;1;5;7;6;-1;1;1;1.00
1705;3;3;5;7;6;-1;3;3;1.00
1706;1;6;5;7;6;-1;1;1;1.00
1707;4;7;5;7;6;-1;1;2;0.50
1708;4;7;5;7;8;1;1;2;0.50
1709;10;7;5;7;6;-1;1;1;1.00
1710;6;2;6;7;6;-1;1;1;1.00
1711;4;3;6;7;6;-1;1;1;1.00
1712;3;4;6;7;6;-1;1;1;1.00
1713;5;4;6;7;6;-1;1;3;0.33
1714;5;4;6;7;7;0;2;3;0.67
1715;9;5;6;7;6;-1;1;1;1.00
1716;5;4;7;7;6;-1;1;2;0.50
1717;5;4;7;7;9;2;1;2;0.50
1718;6;7;9;7;6;-1;1;1;1.00
1719;5;5;10;7;6;-1;1;1;1.00
1720;5;6;10;7;6;-1;1;1;1.00
1721;3;4;2;8;6;-2;1;1;1.00
1722;8;2;3;8;6;-2;1;1;1.00
1723;3;5;3;8;6;-2;1;1;1.00
1724;8;4;4;8;6;-2;1;1;1.00
1725;7;7;4;8;6;-2;2;2;1.00
1726;6;8;4;8;6;-2;1;1;1.00
1727;7;8;4;8;6;-2;1;1;1.00
1728;4;3;5;8;6;-2;2;2;1.00
1729;6;3;5;8;6;-2;1;1;1.00
1730;7;3;5;8;6;-2;1;1;1.00
1731;3;5;5;8;6;-2;1;1;1.00
1732;4;6;5;8;6;-2;1;1;1.00
1733;5;7;5;8;6;-2;1;1;1.00
1734;7;8;5;8;6;-2;1;1;1.00
1735;7;3;6;8;6;-2;1;1;1.00
1736;6;7;6;8;6;-2;1;1;1.00
1737;7;7;6;8;6;-2;1;1;1.00
1738;5;6;7;8;6;-2;1;1;1.00
1739;7;3;8;8;6;-2;1;1;1.00
1740;5;4;8;8;6;-2;1;1;1.00
1741;7;6;8;8;6;-2;1;1;1.00
1742;6;8;2;9;6;-3;1;1;1.00
1743;7;2;3;9;6;-3;1;1;1.00
1744;5;6;4;9;6;-3;1;1;1.00
1745;4;6;6;9;6;-3;1;1;1.00
1746;5;6;6;9;6;-3;1;1;1.00
1747;4;6;8;9;6;-3;1;1;1.00
1748;6;4;9;9;6;-3;1;1;1.00
1749;5;7;5;10;6;-4;1;1;1.00
1750;5;4;6;10;6;-4;1;1;1.00
1751;3;3;7;10;6;-4;1;1;1.00
1752;4;4;2;2;7;5;1;1;1.00
1753;4;6;3;2;7;5;1;1;1.00
1754;6;3;5;2;7;5;1;1;1.00
1755;6;6;6;2;7;5;1;2;0.50
1756;6;6;6;2;9;7;1;2;0.50
1757;7;6;7;2;7;5;1;1;1.00
1758;5;7;7;2;7;5;1;1;1.00
1759;3;8;7;2;7;5;1;1;1.00
1760;5;4;3;3;7;4;1;1;1.00
1761;7;4;3;3;7;4;1;1;1.00
1762;8;4;3;3;7;4;1;1;1.00
1763;5;6;3;3;7;4;1;1;1.00
1764;8;6;3;3;7;4;1;1;1.00
1765;6;3;4;3;7;4;1;1;1.00
1766;4;2;5;3;7;4;1;1;1.00
1767;8;6;5;3;7;4;1;1;1.00
1768;4;7;5;3;7;4;1;1;1.00
1769;7;7;5;3;7;4;1;1;1.00
1770;5;8;5;3;7;4;1;1;1.00
1771;9;3;6;3;7;4;1;1;1.00
1772;3;6;6;3;7;4;1;1;1.00
1773;7;7;6;3;7;4;2;2;1.00
1774;7;8;6;3;7;4;1;1;1.00
1775;5;5;7;3;7;4;1;2;0.50
1776;5;5;7;3;8;5;1;2;0.50
1777;7;6;7;3;7;4;1;1;1.00
1778;3;7;7;3;7;4;1;1;1.00
1779;6;7;7;3;7;4;1;1;1.00
1780;2;4;8;3;7;4;1;1;1.00
1781;4;7;8;3;7;4;1;1;1.00
1782;6;5;1;4;7;3;1;1;1.00
1783;6;3;2;4;7;3;1;1;1.00
1784;4;6;2;4;7;3;1;1;1.00
1785;4;2;3;4;7;3;1;1;1.00
1786;9;2;3;4;7;3;1;1;1.00
1787;4;3;3;4;7;3;1;1;1.00
1788;5;5;3;4;7;3;2;2;1.00
1789;3;5;4;4;7;3;1;2;0.50
1790;3;5;4;4;8;4;1;2;0.50
1791;3;6;4;4;7;3;1;1;1.00
1792;4;8;4;4;7;3;1;1;1.00
1793;3;6;5;4;7;3;1;1;1.00
1794;3;7;5;4;7;3;1;1;1.00
1795;7;8;6;4;7;3;1;1;1.00
1796;8;8;6;4;7;3;1;1;1.00
1797;7;5;7;4;7;3;1;1;1.00
1798;6;2;8;4;7;3;1;1;1.00
1799;7;3;8;4;7;3;1;1;1.00
1800;8;3;8;4;7;3;1;2;0.50
1801;8;3;8;4;9;5;1;2;0.50
1802;7;5;8;4;7;3;1;1;1.00
1803;3;7;8;4;7;3;1;1;1.00
1804;3;8;8;4;7;3;1;1;1.00
1805;7;4;9;4;7;3;1;1;1.00
1806;6;6;10;4;7;3;1;1;1.00
1807;6;7;1;5;7;2;1;1;1.00
1808;7;2;3;5;7;2;1;1;1.00
1809;9;3;3;5;7;2;1;1;1.00
1810;4;6;3;5;7;2;3;4;0.75
1811;4;6;3;5;8;3;1;4;0.25
1812;3;8;3;5;7;2;1;1;1.00
1813;5;3;4;5;7;2;1;1;1.00
1814;10;5;4;5;7;2;1;1;1.00
1815;8;6;4;5;7;2;2;2;1.00
1816;7;8;4;5;7;2;1;1;1.00
1817;6;9;4;5;7;2;1;1;1.00
1818;4;1;5;5;7;2;1;1;1.00
1819;4;4;5;5;7;2;1;2;0.50
1820;4;4;5;5;8;3;1;2;0.50
1821;9;8;5;5;7;2;1;1;1.00
1822;7;1;6;5;7;2;1;1;1.00
1823;2;3;6;5;7;2;1;1;1.00
1824;7;10;6;5;7;2;1;1;1.00
1825;4;3;7;5;7;2;1;1;1.00
1826;6;3;7;5;7;2;1;2;0.50
1827;6;3;7;5;9;4;1;2;0.50
1828;7;4;7;5;7;2;1;1;1.00
1829;8;5;7;5;7;2;2;2;1.00
1830;3;7;7;5;7;2;1;1;1.00
1831;8;7;7;5;7;2;1;1;1.00
1832;4;10;7;5;7;2;1;1;1.00
1833;4;3;8;5;7;2;1;1;1.00
1834;7;3;8;5;7;2;1;1;1.00
1835;6;6;8;5;7;2;1;1;1.00
1836;8;6;8;5;7;2;1;1;1.00
1837;6;7;8;5;7;2;1;2;0.50
1838;6;7;8;5;8;3;1;2;0.50
1839;7;7;8;5;7;2;1;1;1.00
1840;7;5;9;5;7;2;1;1;1.00
1841;5;5;2;6;7;1;1;1;1.00
1842;6;6;2;6;7;1;1;1;1.00
1843;5;5;3;6;7;1;1;1;1.00
1844;5;6;3;6;7;1;1;2;0.50
1845;5;6;3;6;8;2;1;2;0.50
1846;5;7;3;6;7;1;1;1;1.00
1847;3;3;4;6;7;1;1;2;0.50
1848;3;3;4;6;8;2;1;2;0.50
1849;2;6;4;6;7;1;1;1;1.00
1850;8;6;4;6;7;1;1;1;1.00
1851;9;7;4;6;7;1;1;1;1.00
1852;7;9;4;6;7;1;1;1;1.00
1853;7;3;5;6;7;1;1;1;1.00
1854;2;4;5;6;7;1;2;2;1.00
1855;10;4;5;6;7;1;1;1;1.00
1856;8;1;6;6;7;1;1;1;1.00
1857;8;3;6;6;7;1;1;1;1.00
1858;6;8;6;6;7;1;1;1;1.00
1859;8;4;7;6;7;1;2;2;1.00
1860;10;4;7;6;7;1;1;1;1.00
1861;4;5;7;6;7;1;1;1;1.00
1862;2;6;7;6;7;1;1;1;1.00
1863;3;8;7;6;7;1;1;1;1.00
1864;3;6;8;6;7;1;1;1;1.00
1865;5;6;8;6;7;1;1;1;1.00
1866;3;8;8;6;7;1;1;1;1.00
1867;8;2;9;6;7;1;1;1;1.00
1868;2;3;9;6;7;1;1;1;1.00
1869;7;5;10;6;7;1;1;1;1.00
1870;4;2;2;7;7;0;1;1;1.00
1871;8;7;2;7;7;0;1;1;1.00
1872;5;5;3;7;7;0;1;1;1.00
1873;3;6;3;7;7;0;1;1;1.00
1874;3;2;4;7;7;0;1;1;1.00
1875;7;5;4;7;7;0;1;2;0.50
1876;7;5;4;7;8;1;1;2;0.50
1877;4;8;4;7;7;0;1;1;1.00
1878;2;3;5;7;7;0;1;1;1.00
1879;5;4;5;7;7;0;1;1;1.00
1880;1;5;5;7;7;0;1;1;1.00
1881;2;6;5;7;7;0;1;1;1.00
1882;5;3;6;7;7;0;1;1;1.00
1883;7;2;7;7;7;0;1;1;1.00
1884;2;4;7;7;7;0;1;1;1.00
1885;4;8;7;7;7;0;1;1;1.00
1886;6;4;8;7;7;0;1;1;1.00
1887;8;4;9;7;7;0;1;1;1.00
1888;5;5;3;8;7;-1;2;2;1.00
1889;5;5;4;8;7;-1;1;1;1.00
1890;3;6;4;8;7;-1;1;1;1.00
1891;5;7;4;8;7;-1;1;1;1.00
1892;7;9;4;8;7;-1;1;1;1.00
1893;7;4;5;8;7;-1;1;1;1.00
1894;6;9;5;8;7;-1;1;1;1.00
1895;8;6;6;8;7;-1;1;2;0.50
1896;8;6;6;8;9;1;1;2;0.50
1897;4;7;6;8;7;-1;1;2;0.50
1898;4;7;6;8;8;0;1;2;0.50
1899;4;4;7;8;7;-1;1;1;1.00
1900;4;5;7;8;7;-1;1;1;1.00
1901;3;6;7;8;7;-1;1;1;1.00
1902;4;6;7;8;7;-1;1;1;1.00
1903;6;8;7;8;7;-1;1;1;1.00
1904;5;8;8;8;7;-1;1;1;1.00
1905;4;8;4;9;7;-2;1;2;0.50
1906;4;8;4;9;8;-1;1;2;0.50
1907;7;7;5;9;7;-2;1;1;1.00
1908;7;5;6;9;7;-2;1;1;1.00
1909;2;7;6;9;7;-2;1;1;1.00
1910;5;6;7;9;7;-2;1;1;1.00
1911;7;7;7;9;7;-2;1;1;1.00
1912;3;4;4;10;7;-3;1;1;1.00
1913;7;5;5;10;7;-3;1;1;1.00
1914;7;5;6;10;7;-3;1;1;1.00
1915;6;3;4;2;8;6;1;1;1.00
1916;7;3;5;2;8;6;1;1;1.00
1917;5;5;5;2;8;6;1;1;1.00
1918;4;5;6;2;8;6;1;1;1.00
1919;4;8;2;3;8;5;1;1;1.00
1920;8;6;6;3;8;5;1;1;1.00
1921;3;5;7;3;8;5;2;2;1.00
1922;5;8;7;3;8;5;1;1;1.00
1923;7;3;8;3;8;5;1;1;1.00
1924;3;7;8;3;8;5;1;1;1.00
1925;5;7;8;3;8;5;1;1;1.00
1926;8;3;2;4;8;4;1;1;1.00
1927;5;8;2;4;8;4;1;1;1.00
1928;2;7;3;4;8;4;1;1;1.00
1929;8;8;3;4;8;4;1;1;1.00
1930;4;3;4;4;8;4;1;1;1.00
1931;4;7;4;4;8;4;1;1;1.00
1932;8;3;6;4;8;4;1;1;1.00
1933;4;9;6;4;8;4;1;1;1.00
1934;5;4;8;4;8;4;1;2;0.50
1935;5;4;8;4;9;5;1;2;0.50
1936;8;6;8;4;8;4;1;1;1.00
1937;8;7;8;4;8;4;1;1;1.00
1938;8;7;9;4;8;4;1;1;1.00
1939;4;8;2;5;8;3;1;1;1.00
1940;5;7;3;5;8;3;1;1;1.00
1941;2;6;5;5;8;3;1;1;1.00
1942;5;8;5;5;8;3;1;1;1.00
1943;6;10;6;5;8;3;1;1;1.00
1944;5;7;7;5;8;3;1;1;1.00
1945;2;5;8;5;8;3;1;1;1.00
1946;4;6;2;6;8;2;1;1;1.00
1947;7;7;3;6;8;2;1;1;1.00
1948;3;7;5;6;8;2;1;1;1.00
1949;6;8;5;6;8;2;1;1;1.00
1950;2;5;6;6;8;2;1;1;1.00
1951;8;6;6;6;8;2;1;1;1.00
1952;2;8;6;6;8;2;1;1;1.00
1953;5;8;6;6;8;2;1;1;1.00
1954;3;6;7;6;8;2;1;1;1.00
1955;2;3;8;6;8;2;1;1;1.00
1956;6;3;2;7;8;1;1;1;1.00
1957;8;5;3;7;8;1;1;1;1.00
1958;9;4;4;7;8;1;1;1;1.00
1959;8;3;6;7;8;1;1;1;1.00
1960;8;6;6;7;8;1;1;1;1.00
1961;8;4;7;7;8;1;1;1;1.00
1962;8;2;4;8;8;0;1;1;1.00
1963;4;4;4;8;8;0;1;1;1.00
1964;6;5;4;8;8;0;1;1;1.00
1965;3;8;6;8;8;0;1;1;1.00
1966;4;4;8;8;8;0;1;1;1.00
1967;4;5;8;8;8;0;1;1;1.00
1968;3;6;6;9;8;-1;1;1;1.00
1969;5;6;8;2;9;7;1;1;1.00
1970;5;7;2;3;9;6;1;1;1.00
1971;6;3;6;4;9;5;1;1;1.00
1972;2;7;6;5;9;4;1;1;1.00
1973;6;5;4;6;9;3;1;2;0.50
1974;6;5;4;6;10;4;1;2;0.50
1975;3;3;6;6;9;3;1;1;1.00
1976;7;2;7;6;9;3;1;1;1.00
1977;6;6;7;6;9;3;1;1;1.00
1978;3;4;3;7;9;2;1;1;1.00
1979;9;4;6;7;9;2;1;1;1.00
1980;8;7;7;7;9;2;1;1;1.00
1981;8;4;8;7;9;2;1;1;1.00
1982;3;4;6;8;9;1;1;1;1.00
1983;4;8;8;8;9;1;1;1;1.00
1984;3;6;4;9;9;0;1;1;1.00
1985;7;6;8;5;10;5;1;1;1.00
1986;7;7;5;6;10;4;1;1;1.00
1987;0;7;3;4;1;-3;1;9;0.11
1988;0;7;3;4;3;-1;1;9;0.11
1989;0;7;3;4;4;0;2;9;0.22
1990;0;7;3;4;6;2;3;9;0.33
1991;0;7;3;4;7;3;1;9;0.11
1992;0;7;3;4;8;4;1;9;0.11
1993;0;5;5;4;1;-3;1;16;0.06
1994;0;5;5;4;3;-1;1;16;0.06
1995;0;5;5;4;4;0;2;16;0.12
1996;0;5;5;4;5;1;3;16;0.19
1997;0;5;5;4;6;2;6;16;0.38
1998;0;5;5;4;7;3;2;16;0.12
1999;0;5;5;4;8;4;1;16;0.06
2000;0;4;6;5;1;-4;1;22;0.05
2001;0;4;6;5;2;-3;2;22;0.09
2002;0;4;6;5;3;-2;1;22;0.05
2003;0;4;6;5;4;-1;2;22;0.09
2004;0;4;6;5;5;0;4;22;0.18
2005;0;4;6;5;6;1;10;22;0.45
2006;0;4;6;5;8;3;1;22;0.05
2007;0;4;6;5;9;4;1;22;0.05
2008;0;4;6;6;1;-5;1;37;0.03
2009;0;4;6;6;3;-3;1;37;0.03
2010;0;4;6;6;4;-2;5;37;0.14
2011;0;4;6;6;5;-1;11;37;0.30
2012;0;4;6;6;6;0;8;37;0.22
2013;0;4;6;6;7;1;6;37;0.16
2014;0;4;6;6;8;2;3;37;0.08
2015;0;4;6;6;9;3;1;37;0.03
2016;0;4;6;6;10;4;1;37;0.03
2017;0;6;4;7;1;-6;1;14;0.07
2018;0;6;4;7;2;-5;1;14;0.07
2019;0;6;4;7;4;-3;3;14;0.21
2020;0;6;4;7;5;-2;3;14;0.21
2021;0;6;4;7;6;-1;2;14;0.14
2022;0;6;4;7;7;0;4;14;0.29
2023;0;5;6;7;1;-6;1;29;0.03
2024;0;5;6;7;3;-4;2;29;0.07
2025;0;5;6;7;4;-3;5;29;0.17
2026;0;5;6;7;5;-2;6;29;0.21
2027;0;5;6;7;6;-1;6;29;0.21
2028;0;5;6;7;7;0;7;29;0.24
2029;0;5;6;7;8;1;1;29;0.03
2030;0;5;6;7;9;2;1;29;0.03
2031;0;6;7;7;1;-6;1;16;0.06
2032;0;6;7;7;3;-4;1;16;0.06
2033;0;6;7;7;4;-3;2;16;0.12
2034;0;6;7;7;5;-2;4;16;0.25
2035;0;6;7;7;6;-1;4;16;0.25
2036;0;6;7;7;7;0;2;16;0.12
2037;0;6;7;7;8;1;2;16;0.12
2038;0;4;7;8;1;-7;1;6;0.17
2039;0;4;7;8;3;-5;1;6;0.17
2040;0;4;7;8;4;-4;1;6;0.17
2041;0;4;7;8;5;-3;1;6;0.17
2042;0;4;7;8;7;-1;2;6;0.33
2043;0;4;4;2;2;0;1;4;0.25
2044;0;4;4;2;4;2;1;4;0.25
2045;0;4;4;2;5;3;2;4;0.50
2046;0;4;6;3;2;-1;1;7;0.14
2047;0;4;6;3;4;1;1;7;0.14
2048;0;4;6;3;5;2;4;7;0.57
2049;0;4;6;3;7;4;1;7;0.14
2050;0;7;6;3;2;-1;1;7;0.14
2051;0;7;6;3;4;1;1;7;0.14
2052;0;7;6;3;6;3;2;7;0.29
2053;0;7;6;3;7;4;3;7;0.43
2054;0;2;8;3;2;-1;1;1;1.00
2055;0;8;9;3;2;-1;1;1;1.00
2056;0;6;3;4;2;-2;1;6;0.17
2057;0;6;3;4;3;-1;1;6;0.17
2058;0;6;3;4;5;1;1;6;0.17
2059;0;6;3;4;6;2;3;6;0.50
2060;0;5;4;4;2;-2;1;14;0.07
2061;0;5;4;4;3;-1;1;14;0.07
2062;0;5;4;4;4;0;3;14;0.21
2063;0;5;4;4;5;1;2;14;0.14
2064;0;5;4;4;6;2;2;14;0.14
2065;0;5;4;4;7;3;2;14;0.14
2066;0;5;4;4;8;4;1;14;0.07
2067;0;5;4;4;9;5;2;14;0.14
2068;0;6;4;4;2;-2;2;12;0.17
2069;0;6;4;4;3;-1;1;12;0.08
2070;0;6;4;4;4;0;2;12;0.17
2071;0;6;4;4;5;1;1;12;0.08
2072;0;6;4;4;6;2;2;12;0.17
2073;0;6;4;4;7;3;2;12;0.17
2074;0;6;4;4;8;4;2;12;0.17
2075;0;8;4;4;2;-2;1;3;0.33
2076;0;8;4;4;7;3;1;3;0.33
2077;0;8;4;4;8;4;1;3;0.33
2078;0;6;5;4;2;-2;1;16;0.06
2079;0;6;5;4;4;0;2;16;0.12
2080;0;6;5;4;5;1;5;16;0.31
2081;0;6;5;4;6;2;2;16;0.12
2082;0;6;5;4;7;3;5;16;0.31
2083;0;6;5;4;8;4;1;16;0.06
2084;0;8;5;4;2;-2;1;5;0.20
2085;0;8;5;4;4;0;2;5;0.40
2086;0;8;5;4;6;2;2;5;0.40
2087;0;7;7;4;2;-2;1;12;0.08
2088;0;7;7;4;3;-1;2;12;0.17
2089;0;7;7;4;4;0;2;12;0.17
2090;0;7;7;4;5;1;1;12;0.08
2091;0;7;7;4;6;2;3;12;0.25
2092;0;7;7;4;8;4;2;12;0.17
2093;0;7;7;4;9;5;1;12;0.08
2094;0;5;8;4;2;-2;1;6;0.17
2095;0;5;8;4;5;1;1;6;0.17
2096;0;5;8;4;6;2;2;6;0.33
2097;0;5;8;4;7;3;1;6;0.17
2098;0;5;8;4;9;5;1;6;0.17
2099;0;5;9;4;2;-2;1;5;0.20
2100;0;5;9;4;4;0;2;5;0.40
2101;0;5;9;4;5;1;1;5;0.20
2102;0;5;9;4;6;2;1;5;0.20
2103;0;6;3;5;2;-3;1;9;0.11
2104;0;6;3;5;4;-1;1;9;0.11
2105;0;6;3;5;6;1;3;9;0.33
2106;0;6;3;5;7;2;3;9;0.33
2107;0;6;3;5;8;3;1;9;0.11
2108;0;7;3;5;2;-3;1;4;0.25
2109;0;7;3;5;5;0;1;4;0.25
2110;0;7;3;5;6;1;1;4;0.25
2111;0;7;3;5;8;3;1;4;0.25
2112;0;5;4;5;2;-3;1;16;0.06
2113;0;5;4;5;4;-1;2;16;0.12
2114;0;5;4;5;5;0;4;16;0.25
2115;0;5;4;5;6;1;4;16;0.25
2116;0;5;4;5;7;2;1;16;0.06
2117;0;5;4;5;8;3;4;16;0.25
2118;0;4;5;5;2;-3;1;14;0.07
2119;0;4;5;5;4;-1;3;14;0.21
2120;0;4;5;5;5;0;4;14;0.29
2121;0;4;5;5;6;1;2;14;0.14
2122;0;4;5;5;7;2;2;14;0.14
2123;0;4;5;5;8;3;2;14;0.14
2124;0;5;5;5;2;-3;1;31;0.03
2125;0;5;5;5;3;-2;2;31;0.06
2126;0;5;5;5;4;-1;4;31;0.13
2127;0;5;5;5;5;0;4;31;0.13
2128;0;5;5;5;6;1;9;31;0.29
2129;0;5;5;5;7;2;8;31;0.26
2130;0;5;5;5;8;3;2;31;0.06
2131;0;5;5;5;9;4;1;31;0.03
2132;0;6;5;5;2;-3;2;29;0.07
2133;0;6;5;5;3;-2;3;29;0.10
2134;0;6;5;5;4;-1;2;29;0.07
2135;0;6;5;5;5;0;5;29;0.17
2136;0;6;5;5;6;1;9;29;0.31
2137;0;6;5;5;7;2;3;29;0.10
2138;0;6;5;5;8;3;4;29;0.14
2139;0;6;5;5;9;4;1;29;0.03
2140;0;7;5;5;2;-3;1;22;0.05
2141;0;7;5;5;3;-2;3;22;0.14
2142;0;7;5;5;4;-1;3;22;0.14
2143;0;7;5;5;5;0;7;22;0.32
2144;0;7;5;5;6;1;2;22;0.09
2145;0;7;5;5;7;2;3;22;0.14
2146;0;7;5;5;8;3;2;22;0.09
2147;0;7;5;5;10;5;1;22;0.05
2148;0;5;6;5;2;-3;1;31;0.03
2149;0;5;6;5;4;-1;7;31;0.23
2150;0;5;6;5;5;0;7;31;0.23
2151;0;5;6;5;6;1;9;31;0.29
2152;0;5;6;5;7;2;6;31;0.19
2153;0;5;6;5;9;4;1;31;0.03
2154;0;6;7;5;2;-3;1;26;0.04
2155;0;6;7;5;3;-2;1;26;0.04
2156;0;6;7;5;4;-1;6;26;0.23
2157;0;6;7;5;5;0;7;26;0.27
2158;0;6;7;5;6;1;6;26;0.23
2159;0;6;7;5;7;2;2;26;0.08
2160;0;6;7;5;8;3;1;26;0.04
2161;0;6;7;5;9;4;2;26;0.08
2162;0;4;3;6;2;-4;1;5;0.20
2163;0;4;3;6;4;-2;1;5;0.20
2164;0;4;3;6;5;-1;1;5;0.20
2165;0;4;3;6;6;0;1;5;0.20
2166;0;4;3;6;7;1;1;5;0.20
2167;0;3;4;6;2;-4;1;12;0.08
2168;0;3;4;6;3;-3;1;12;0.08
2169;0;3;4;6;4;-2;4;12;0.33
2170;0;3;4;6;5;-1;2;12;0.17
2171;0;3;4;6;6;0;1;12;0.08
2172;0;3;4;6;7;1;1;12;0.08
2173;0;3;4;6;8;2;1;12;0.08
2174;0;3;4;6;9;3;1;12;0.08
2175;0;9;4;6;2;-4;1;4;0.25
2176;0;9;4;6;4;-2;2;4;0.50
2177;0;9;4;6;7;1;1;4;0.25
2178;0;4;5;6;2;-4;1;21;0.05
2179;0;4;5;6;4;-2;3;21;0.14
2180;0;4;5;6;5;-1;4;21;0.19
2181;0;4;5;6;6;0;5;21;0.24
2182;0;4;5;6;7;1;5;21;0.24
2183;0;4;5;6;8;2;3;21;0.14
2184;0;3;6;6;2;-4;1;8;0.12
2185;0;3;6;6;3;-3;1;8;0.12
2186;0;3;6;6;4;-2;2;8;0.25
2187;0;3;6;6;5;-1;1;8;0.12
2188;0;3;6;6;7;1;2;8;0.25
2189;0;3;6;6;9;3;1;8;0.12
2190;0;6;6;6;2;-4;2;28;0.07
2191;0;6;6;6;3;-3;4;28;0.14
2192;0;6;6;6;4;-2;2;28;0.07
2193;0;6;6;6;5;-1;5;28;0.18
2194;0;6;6;6;6;0;9;28;0.32
2195;0;6;6;6;7;1;5;28;0.18
2196;0;6;6;6;8;2;1;28;0.04
2197;0;7;7;6;2;-4;1;14;0.07
2198;0;7;7;6;3;-3;2;14;0.14
2199;0;7;7;6;4;-2;1;14;0.07
2200;0;7;7;6;5;-1;2;14;0.14
2201;0;7;7;6;6;0;1;14;0.07
2202;0;7;7;6;7;1;3;14;0.21
2203;0;7;7;6;8;2;1;14;0.07
2204;0;7;7;6;9;3;2;14;0.14
2205;0;7;7;6;10;4;1;14;0.07
2206;0;7;4;7;2;-5;1;11;0.09
2207;0;7;4;7;3;-4;1;11;0.09
2208;0;7;4;7;4;-3;2;11;0.18
2209;0;7;4;7;5;-2;1;11;0.09
2210;0;7;4;7;6;-1;2;11;0.18
2211;0;7;4;7;7;0;1;11;0.09
2212;0;7;4;7;8;1;3;11;0.27
2213;0;6;5;7;2;-5;1;21;0.05
2214;0;6;5;7;3;-4;1;21;0.05
2215;0;6;5;7;4;-3;2;21;0.10
2216;0;6;5;7;5;-2;5;21;0.24
2217;0;6;5;7;6;-1;6;21;0.29
2218;0;6;5;7;7;0;5;21;0.24
2219;0;6;5;7;8;1;1;21;0.05
2220;0;7;5;7;2;-5;2;18;0.11
2221;0;7;5;7;3;-4;1;18;0.06
2222;0;7;5;7;4;-3;1;18;0.06
2223;0;7;5;7;5;-2;8;18;0.44
2224;0;7;5;7;6;-1;3;18;0.17
2225;0;7;5;7;7;0;2;18;0.11
2226;0;7;5;7;8;1;1;18;0.06
2227;0;7;6;7;2;-5;1;14;0.07
2228;0;7;6;7;3;-4;1;14;0.07
2229;0;7;6;7;4;-3;4;14;0.29
2230;0;7;6;7;5;-2;4;14;0.29
2231;0;7;6;7;6;-1;2;14;0.14
2232;0;7;6;7;8;1;2;14;0.14
2233;0;5;7;7;2;-5;1;14;0.07
2234;0;5;7;7;4;-3;6;14;0.43
2235;0;5;7;7;5;-2;1;14;0.07
2236;0;5;7;7;6;-1;6;14;0.43
2237;0;3;8;7;2;-5;1;2;0.50
2238;0;3;8;7;6;-1;1;2;0.50
2239;0;4;4;8;2;-6;1;7;0.14
2240;0;4;4;8;4;-4;3;7;0.43
2241;0;4;4;8;6;-2;2;7;0.29
2242;0;4;4;8;8;0;1;7;0.14
2243;0;6;4;8;2;-6;1;3;0.33
2244;0;6;4;8;5;-3;1;3;0.33
2245;0;6;4;8;7;-1;1;3;0.33
2246;0;8;5;8;2;-6;1;2;0.50
2247;0;8;5;8;6;-2;1;2;0.50
2248;0;5;6;8;2;-6;1;10;0.10
2249;0;5;6;8;3;-5;2;10;0.20
2250;0;5;6;8;4;-4;2;10;0.20
2251;0;5;6;8;5;-3;1;10;0.10
2252;0;5;6;8;6;-2;1;10;0.10
2253;0;5;6;8;7;-1;2;10;0.20
2254;0;5;6;8;9;1;1;10;0.10
2255;0;5;2;9;2;-7;1;1;1.00
2256;0;4;6;9;2;-7;1;5;0.20
2257;0;4;6;9;4;-5;1;5;0.20
2258;0;4;6;9;5;-4;2;5;0.40
2259;0;4;6;9;7;-2;1;5;0.20
2260;0;5;4;1;3;2;1;1;1.00
2261;0;5;4;2;3;1;1;2;0.50
2262;0;5;4;2;5;3;1;2;0.50
2263;0;8;4;2;3;1;1;1;1.00
2264;0;4;5;2;3;1;1;1;1.00
2265;0;5;5;2;3;1;1;5;0.20
2266;0;5;5;2;4;2;1;5;0.20
2267;0;5;5;2;6;4;1;5;0.20
2268;0;5;5;2;7;5;1;5;0.20
2269;0;5;5;2;8;6;1;5;0.20
2270;0;7;6;2;3;1;1;1;1.00
2271;0;4;7;2;3;1;1;2;0.50
2272;0;4;7;2;5;3;1;2;0.50
2273;0;5;7;2;3;1;1;3;0.33
2274;0;5;7;2;5;3;1;3;0.33
2275;0;5;7;2;7;5;1;3;0.33
2276;0;4;8;2;3;1;1;2;0.50
2277;0;4;8;2;5;3;1;2;0.50
2278;0;6;9;2;3;1;1;1;1.00
2279;0;5;2;3;3;0;1;2;0.50
2280;0;5;2;3;6;3;1;2;0.50
2281;0;5;4;3;3;0;1;4;0.25
2282;0;5;4;3;5;2;2;4;0.50
2283;0;5;4;3;6;3;1;4;0.25
2284;0;6;4;3;3;0;1;8;0.12
2285;0;6;4;3;4;1;1;8;0.12
2286;0;6;4;3;5;2;3;8;0.38
2287;0;6;4;3;6;3;2;8;0.25
2288;0;6;4;3;7;4;1;8;0.12
2289;0;7;4;3;3;0;1;9;0.11
2290;0;7;4;3;4;1;2;9;0.22
2291;0;7;4;3;5;2;5;9;0.56
2292;0;7;4;3;6;3;1;9;0.11
2293;0;8;4;3;3;0;1;4;0.25
2294;0;8;4;3;5;2;2;4;0.50
2295;0;8;4;3;8;5;1;4;0.25
2296;0;5;5;3;3;0;3;10;0.30
2297;0;5;5;3;4;1;2;10;0.20
2298;0;5;5;3;5;2;1;10;0.10
2299;0;5;5;3;6;3;1;10;0.10
2300;0;5;5;3;7;4;1;10;0.10
2301;0;5;5;3;8;5;2;10;0.20
2302;0;6;5;3;3;0;1;7;0.14
2303;0;6;5;3;5;2;1;7;0.14
2304;0;6;5;3;6;3;4;7;0.57
2305;0;6;5;3;7;4;1;7;0.14
2306;0;5;6;3;3;0;1;8;0.12
2307;0;5;6;3;4;1;1;8;0.12
2308;0;5;6;3;5;2;3;8;0.38
2309;0;5;6;3;6;3;2;8;0.25
2310;0;5;6;3;7;4;1;8;0.12
2311;0;6;6;3;3;0;1;14;0.07
2312;0;6;6;3;4;1;2;14;0.14
2313;0;6;6;3;5;2;1;14;0.07
2314;0;6;6;3;6;3;5;14;0.36
2315;0;6;6;3;7;4;3;14;0.21
2316;0;6;6;3;8;5;2;14;0.14
2317;0;8;6;3;3;0;1;3;0.33
2318;0;8;6;3;5;2;1;3;0.33
2319;0;8;6;3;7;4;1;3;0.33
2320;0;9;6;3;3;0;1;3;0.33
2321;0;9;6;3;4;1;1;3;0.33
2322;0;9;6;3;7;4;1;3;0.33
2323;0;3;7;3;3;0;1;3;0.33
2324;0;3;7;3;4;1;2;3;0.67
2325;0;5;7;3;3;0;1;12;0.08
2326;0;5;7;3;4;1;4;12;0.33
2327;0;5;7;3;5;2;1;12;0.08
2328;0;5;7;3;6;3;1;12;0.08
2329;0;5;7;3;7;4;2;12;0.17
2330;0;5;7;3;8;5;3;12;0.25
2331;0;6;8;3;3;0;2;9;0.22
2332;0;6;8;3;4;1;3;9;0.33
2333;0;6;8;3;5;2;1;9;0.11
2334;0;6;8;3;6;3;2;9;0.22
2335;0;6;8;3;7;4;1;9;0.11
2336;0;6;9;3;3;0;1;1;1.00
2337;0;2;5;4;3;-1;1;2;0.50
2338;0;2;5;4;6;2;1;2;0.50
2339;0;4;5;4;3;-1;1;11;0.09
2340;0;4;5;4;4;0;1;11;0.09
2341;0;4;5;4;5;1;2;11;0.18
2342;0;4;5;4;6;2;5;11;0.45
2343;0;4;5;4;7;3;2;11;0.18
2344;0;7;5;4;3;-1;1;16;0.06
2345;0;7;5;4;4;0;4;16;0.25
2346;0;7;5;4;5;1;3;16;0.19
2347;0;7;5;4;6;2;3;16;0.19
2348;0;7;5;4;7;3;2;16;0.12
2349;0;7;5;4;8;4;3;16;0.19
2350;0;4;6;4;3;-1;3;18;0.17
2351;0;4;6;4;4;0;3;18;0.17
2352;0;4;6;4;5;1;5;18;0.28
2353;0;4;6;4;6;2;6;18;0.33
2354;0;4;6;4;8;4;1;18;0.06
2355;0;5;6;4;3;-1;5;22;0.23
2356;0;5;6;4;4;0;5;22;0.23
2357;0;5;6;4;5;1;4;22;0.18
2358;0;5;6;4;6;2;2;22;0.09
2359;0;5;6;4;7;3;5;22;0.23
2360;0;5;6;4;9;5;1;22;0.05
2361;0;2;7;4;3;-1;1;2;0.50
2362;0;2;7;4;6;2;1;2;0.50
2363;0;3;7;4;3;-1;3;9;0.33
2364;0;3;7;4;4;0;1;9;0.11
2365;0;3;7;4;6;2;4;9;0.44
2366;0;3;7;4;7;3;1;9;0.11
2367;0;4;7;4;3;-1;1;12;0.08
2368;0;4;7;4;4;0;1;12;0.08
2369;0;4;7;4;5;1;1;12;0.08
2370;0;4;7;4;6;2;6;12;0.50
2371;0;4;7;4;7;3;3;12;0.25
2372;0;6;7;4;3;-1;1;17;0.06
2373;0;6;7;4;4;0;2;17;0.12
2374;0;6;7;4;5;1;6;17;0.35
2375;0;6;7;4;6;2;6;17;0.35
2376;0;6;7;4;7;3;2;17;0.12
2377;0;8;7;4;3;-1;1;6;0.17
2378;0;8;7;4;4;0;2;6;0.33
2379;0;8;7;4;5;1;1;6;0.17
2380;0;8;7;4;7;3;2;6;0.33
2381;0;6;8;4;3;-1;2;9;0.22
2382;0;6;8;4;5;1;2;9;0.22
2383;0;6;8;4;6;2;4;9;0.44
2384;0;6;8;4;8;4;1;9;0.11
2385;0;7;8;4;3;-1;2;8;0.25
2386;0;7;8;4;4;0;2;8;0.25
2387;0;7;8;4;5;1;1;8;0.12
2388;0;7;8;4;6;2;1;8;0.12
2389;0;7;8;4;7;3;1;8;0.12
2390;0;7;8;4;8;4;1;8;0.12
2391;0;4;2;5;3;-2;1;3;0.33
2392;0;4;2;5;4;-1;1;3;0.33
2393;0;4;2;5;6;1;1;3;0.33
2394;0;7;2;5;3;-2;1;2;0.50
2395;0;7;2;5;4;-1;1;2;0.50
2396;0;3;3;5;3;-2;1;6;0.17
2397;0;3;3;5;5;0;1;6;0.17
2398;0;3;3;5;6;1;1;6;0.17
2399;0;3;3;5;7;2;3;6;0.50
2400;0;4;3;5;3;-2;2;14;0.14
2401;0;4;3;5;4;-1;2;14;0.14
2402;0;4;3;5;5;0;3;14;0.21
2403;0;4;3;5;6;1;3;14;0.21
2404;0;4;3;5;7;2;1;14;0.07
2405;0;4;3;5;8;3;2;14;0.14
2406;0;4;3;5;9;4;1;14;0.07
2407;0;6;4;5;3;-2;2;22;0.09
2408;0;6;4;5;4;-1;4;22;0.18
2409;0;6;4;5;5;0;4;22;0.18
2410;0;6;4;5;6;1;5;22;0.23
2411;0;6;4;5;7;2;5;22;0.23
2412;0;6;4;5;9;4;2;22;0.09
2413;0;7;4;5;3;-2;2;14;0.14
2414;0;7;4;5;4;-1;5;14;0.36
2415;0;7;4;5;5;0;3;14;0.21
2416;0;7;4;5;7;2;3;14;0.21
2417;0;7;4;5;8;3;1;14;0.07
2418;0;9;5;5;3;-2;2;8;0.25
2419;0;9;5;5;4;-1;2;8;0.25
2420;0;9;5;5;5;0;4;8;0.50
2421;0;3;6;5;3;-2;2;11;0.18
2422;0;3;6;5;4;-1;1;11;0.09
2423;0;3;6;5;5;0;2;11;0.18
2424;0;3;6;5;6;1;4;11;0.36
2425;0;3;6;5;7;2;1;11;0.09
2426;0;3;6;5;8;3;1;11;0.09
2427;0;6;6;5;3;-2;1;28;0.04
2428;0;6;6;5;4;-1;1;28;0.04
2429;0;6;6;5;5;0;13;28;0.46
2430;0;6;6;5;6;1;3;28;0.11
2431;0;6;6;5;7;2;4;28;0.14
2432;0;6;6;5;8;3;4;28;0.14
2433;0;6;6;5;9;4;1;28;0.04
2434;0;6;6;5;10;5;1;28;0.04
2435;0;8;6;5;3;-2;1;8;0.12
2436;0;8;6;5;4;-1;3;8;0.38
2437;0;8;6;5;6;1;1;8;0.12
2438;0;8;6;5;7;2;3;8;0.38
2439;0;9;6;5;3;-2;2;2;1.00
2440;0;4;7;5;3;-2;1;17;0.06
2441;0;4;7;5;4;-1;4;17;0.24
2442;0;4;7;5;5;0;3;17;0.18
2443;0;4;7;5;6;1;4;17;0.24
2444;0;4;7;5;7;2;2;17;0.12
2445;0;4;7;5;8;3;3;17;0.18
2446;0;5;7;5;3;-2;2;24;0.08
2447;0;5;7;5;4;-1;1;24;0.04
2448;0;5;7;5;5;0;8;24;0.33
2449;0;5;7;5;6;1;6;24;0.25
2450;0;5;7;5;7;2;5;24;0.21
2451;0;5;7;5;8;3;1;24;0.04
2452;0;5;7;5;10;5;1;24;0.04
2453;0;7;7;5;3;-2;1;12;0.08
2454;0;7;7;5;4;-1;2;12;0.17
2455;0;7;7;5;5;0;2;12;0.17
2456;0;7;7;5;6;1;1;12;0.08
2457;0;7;7;5;7;2;4;12;0.33
2458;0;7;7;5;8;3;1;12;0.08
2459;0;7;7;5;9;4;1;12;0.08
2460;0;8;7;5;3;-2;2;10;0.20
2461;0;8;7;5;4;-1;1;10;0.10
2462;0;8;7;5;5;0;2;10;0.20
2463;0;8;7;5;6;1;3;10;0.30
2464;0;8;7;5;7;2;2;10;0.20
2465;0;9;7;5;3;-2;2;2;1.00
2466;0;5;8;5;3;-2;1;11;0.09
2467;0;5;8;5;4;-1;3;11;0.27
2468;0;5;8;5;5;0;1;11;0.09
2469;0;5;8;5;6;1;4;11;0.36
2470;0;5;8;5;8;3;1;11;0.09
2471;0;5;8;5;10;5;1;11;0.09
2472;0;6;8;5;3;-2;1;6;0.17
2473;0;6;8;5;5;0;1;6;0.17
2474;0;6;8;5;6;1;1;6;0.17
2475;0;6;8;5;7;2;2;6;0.33
2476;0;6;8;5;10;5;1;6;0.17
2477;0;4;9;5;3;-2;1;2;0.50
2478;0;4;9;5;5;0;1;2;0.50
2479;0;8;9;5;3;-2;1;2;0.50
2480;0;8;9;5;7;2;1;2;0.50
2481;0;9;3;6;3;-3;1;1;1.00
2482;0;5;4;6;3;-3;2;21;0.10
2483;0;5;4;6;4;-2;3;21;0.14
2484;0;5;4;6;5;-1;1;21;0.05
2485;0;5;4;6;6;0;7;21;0.33
2486;0;5;4;6;7;1;3;21;0.14
2487;0;5;4;6;8;2;1;21;0.05
2488;0;5;4;6;9;3;3;21;0.14
2489;0;5;4;6;10;4;1;21;0.05
2490;0;6;4;6;3;-3;2;27;0.07
2491;0;6;4;6;4;-2;5;27;0.19
2492;0;6;4;6;5;-1;6;27;0.22
2493;0;6;4;6;6;0;9;27;0.33
2494;0;6;4;6;7;1;3;27;0.11
2495;0;6;4;6;8;2;2;27;0.07
2496;0;7;4;6;3;-3;1;21;0.05
2497;0;7;4;6;4;-2;3;21;0.14
2498;0;7;4;6;5;-1;6;21;0.29
2499;0;7;4;6;6;0;7;21;0.33
2500;0;7;4;6;7;1;2;21;0.10
2501;0;7;4;6;8;2;1;21;0.05
2502;0;7;4;6;9;3;1;21;0.05
2503;0;8;4;6;3;-3;1;8;0.12
2504;0;8;4;6;5;-1;2;8;0.25
2505;0;8;4;6;6;0;4;8;0.50
2506;0;8;4;6;8;2;1;8;0.12
2507;0;5;5;6;3;-3;3;27;0.11
2508;0;5;5;6;4;-2;7;27;0.26
2509;0;5;5;6;5;-1;4;27;0.15
2510;0;5;5;6;6;0;4;27;0.15
2511;0;5;5;6;7;1;8;27;0.30
2512;0;5;5;6;8;2;1;27;0.04
2513;0;6;5;6;3;-3;2;29;0.07
2514;0;6;5;6;4;-2;4;29;0.14
2515;0;6;5;6;5;-1;7;29;0.24
2516;0;6;5;6;6;0;5;29;0.17
2517;0;6;5;6;7;1;6;29;0.21
2518;0;6;5;6;8;2;4;29;0.14
2519;0;6;5;6;9;3;1;29;0.03
2520;0;7;5;6;3;-3;1;21;0.05
2521;0;7;5;6;4;-2;5;21;0.24
2522;0;7;5;6;5;-1;7;21;0.33
2523;0;7;5;6;6;0;2;21;0.10
2524;0;7;5;6;7;1;3;21;0.14
2525;0;7;5;6;8;2;1;21;0.05
2526;0;7;5;6;9;3;1;21;0.05
2527;0;7;5;6;10;4;1;21;0.05
2528;0;8;5;6;3;-3;2;11;0.18
2529;0;8;5;6;4;-2;2;11;0.18
2530;0;8;5;6;5;-1;2;11;0.18
2531;0;8;5;6;6;0;4;11;0.36
2532;0;8;5;6;8;2;1;11;0.09
2533;0;5;6;6;3;-3;4;24;0.17
2534;0;5;6;6;4;-2;4;24;0.17
2535;0;5;6;6;5;-1;4;24;0.17
2536;0;5;6;6;6;0;6;24;0.25
2537;0;5;6;6;7;1;3;24;0.12
2538;0;5;6;6;8;2;2;24;0.08
2539;0;5;6;6;9;3;1;24;0.04
2540;0;7;6;6;3;-3;3;14;0.21
2541;0;7;6;6;4;-2;1;14;0.07
2542;0;7;6;6;5;-1;5;14;0.36
2543;0;7;6;6;6;0;3;14;0.21
2544;0;7;6;6;7;1;1;14;0.07
2545;0;7;6;6;8;2;1;14;0.07
2546;0;8;6;6;3;-3;1;6;0.17
2547;0;8;6;6;5;-1;1;6;0.17
2548;0;8;6;6;6;0;1;6;0.17
2549;0;8;6;6;7;1;1;6;0.17
2550;0;8;6;6;8;2;2;6;0.33
2551;0;3;7;6;3;-3;1;7;0.14
2552;0;3;7;6;4;-2;1;7;0.14
2553;0;3;7;6;6;0;4;7;0.57
2554;0;3;7;6;8;2;1;7;0.14
2555;0;4;7;6;3;-3;1;16;0.06
2556;0;4;7;6;4;-2;5;16;0.31
2557;0;4;7;6;5;-1;4;16;0.25
2558;0;4;7;6;7;1;4;16;0.25
2559;0;4;7;6;8;2;2;16;0.12
2560;0;5;7;6;3;-3;2;17;0.12
2561;0;5;7;6;4;-2;3;17;0.18
2562;0;5;7;6;5;-1;4;17;0.24
2563;0;5;7;6;6;0;4;17;0.24
2564;0;5;7;6;7;1;4;17;0.24
2565;0;6;7;6;3;-3;1;14;0.07
2566;0;6;7;6;4;-2;3;14;0.21
2567;0;6;7;6;5;-1;2;14;0.14
2568;0;6;7;6;6;0;4;14;0.29
2569;0;6;7;6;7;1;2;14;0.14
2570;0;6;7;6;8;2;1;14;0.07
2571;0;6;7;6;9;3;1;14;0.07
2572;0;5;8;6;3;-3;1;10;0.10
2573;0;5;8;6;4;-2;1;10;0.10
2574;0;5;8;6;5;-1;3;10;0.30
2575;0;5;8;6;6;0;1;10;0.10
2576;0;5;8;6;7;1;2;10;0.20
2577;0;5;8;6;8;2;2;10;0.20
2578;0;6;8;6;3;-3;1;5;0.20
2579;0;6;8;6;6;0;1;5;0.20
2580;0;6;8;6;7;1;3;5;0.60
2581;0;7;8;6;3;-3;1;3;0.33
2582;0;7;8;6;4;-2;1;3;0.33
2583;0;7;8;6;6;0;1;3;0.33
2584;0;4;9;6;3;-3;1;2;0.50
2585;0;4;9;6;4;-2;1;2;0.50
2586;0;6;9;6;3;-3;2;3;0.67
2587;0;6;9;6;4;-2;1;3;0.33
2588;0;5;2;7;3;-4;1;2;0.50
2589;0;5;2;7;6;-1;1;2;0.50
2590;0;3;3;7;3;-4;1;6;0.17
2591;0;3;3;7;4;-3;3;6;0.50
2592;0;3;3;7;5;-2;1;6;0.17
2593;0;3;3;7;10;3;1;6;0.17
2594;0;6;3;7;3;-4;2;11;0.18
2595;0;6;3;7;4;-3;4;11;0.36
2596;0;6;3;7;5;-2;2;11;0.18
2597;0;6;3;7;6;-1;1;11;0.09
2598;0;6;3;7;7;0;1;11;0.09
2599;0;6;3;7;8;1;1;11;0.09
2600;0;3;5;7;3;-4;2;10;0.20
2601;0;3;5;7;5;-2;3;10;0.30
2602;0;3;5;7;6;-1;3;10;0.30
2603;0;3;5;7;7;0;2;10;0.20
2604;0;4;5;7;3;-4;5;13;0.38
2605;0;4;5;7;4;-3;2;13;0.15
2606;0;4;5;7;5;-2;2;13;0.15
2607;0;4;5;7;6;-1;1;13;0.08
2608;0;4;5;7;7;0;2;13;0.15
2609;0;4;5;7;8;1;1;13;0.08
2610;0;5;5;7;3;-4;2;18;0.11
2611;0;5;5;7;4;-3;3;18;0.17
2612;0;5;5;7;5;-2;2;18;0.11
2613;0;5;5;7;6;-1;3;18;0.17
2614;0;5;5;7;7;0;3;18;0.17
2615;0;5;5;7;8;1;4;18;0.22
2616;0;5;5;7;9;2;1;18;0.06
2617;0;8;5;7;3;-4;1;6;0.17
2618;0;8;5;7;4;-3;2;6;0.33
2619;0;8;5;7;5;-2;2;6;0.33
2620;0;8;5;7;8;1;1;6;0.17
2621;0;4;6;7;3;-4;1;11;0.09
2622;0;4;6;7;4;-3;1;11;0.09
2623;0;4;6;7;5;-2;2;11;0.18
2624;0;4;6;7;6;-1;2;11;0.18
2625;0;4;6;7;7;0;3;11;0.27
2626;0;4;6;7;8;1;1;11;0.09
2627;0;4;6;7;9;2;1;11;0.09
2628;0;6;6;7;3;-4;2;19;0.11
2629;0;6;6;7;4;-3;5;19;0.26
2630;0;6;6;7;5;-2;6;19;0.32
2631;0;6;6;7;6;-1;1;19;0.05
2632;0;6;6;7;7;0;3;19;0.16
2633;0;6;6;7;8;1;2;19;0.11
2634;0;3;7;7;3;-4;1;4;0.25
2635;0;3;7;7;4;-3;2;4;0.50
2636;0;3;7;7;5;-2;1;4;0.25
2637;0;7;7;7;3;-4;1;6;0.17
2638;0;7;7;7;4;-3;1;6;0.17
2639;0;7;7;7;5;-2;2;6;0.33
2640;0;7;7;7;6;-1;1;6;0.17
2641;0;7;7;7;9;2;1;6;0.17
2642;0;5;8;7;3;-4;1;7;0.14
2643;0;5;8;7;4;-3;2;7;0.29
2644;0;5;8;7;5;-2;2;7;0.29
2645;0;5;8;7;7;0;1;7;0.14
2646;0;5;8;7;8;1;1;7;0.14
2647;0;6;8;7;3;-4;1;4;0.25
2648;0;6;8;7;4;-3;2;4;0.50
2649;0;6;8;7;8;1;1;4;0.25
2650;0;7;8;7;3;-4;1;9;0.11
2651;0;7;8;7;4;-3;2;9;0.22
2652;0;7;8;7;5;-2;4;9;0.44
2653;0;7;8;7;8;1;2;9;0.22
2654;0;5;2;8;3;-5;1;2;0.50
2655;0;5;2;8;5;-3;1;2;0.50
2656;0;6;3;8;3;-5;1;2;0.50
2657;0;6;3;8;8;0;1;2;0.50
2658;0;7;3;8;3;-5;1;4;0.25
2659;0;7;3;8;4;-4;1;4;0.25
2660;0;7;3;8;5;-3;1;4;0.25
2661;0;7;3;8;8;0;1;4;0.25
2662;0;2;4;8;3;-5;1;2;0.50
2663;0;2;4;8;8;0;1;2;0.50
2664;0;5;5;8;3;-5;1;12;0.08
2665;0;5;5;8;4;-4;3;12;0.25
2666;0;5;5;8;5;-3;4;12;0.33
2667;0;5;5;8;6;-2;2;12;0.17
2668;0;5;5;8;7;-1;2;12;0.17
2669;0;6;5;8;3;-5;2;9;0.22
2670;0;6;5;8;4;-4;2;9;0.22
2671;0;6;5;8;5;-3;2;9;0.22
2672;0;6;5;8;6;-2;1;9;0.11
2673;0;6;5;8;7;-1;1;9;0.11
2674;0;6;5;8;8;0;1;9;0.11
2675;0;4;6;8;3;-5;4;8;0.50
2676;0;4;6;8;4;-4;1;8;0.12
2677;0;4;6;8;5;-3;2;8;0.25
2678;0;4;6;8;9;1;1;8;0.12
2679;0;6;6;8;3;-5;3;9;0.33
2680;0;6;6;8;4;-4;2;9;0.22
2681;0;6;6;8;5;-3;1;9;0.11
2682;0;6;6;8;6;-2;1;9;0.11
2683;0;6;6;8;7;-1;1;9;0.11
2684;0;6;6;8;9;1;1;9;0.11
2685;0;3;7;8;3;-5;1;2;0.50
2686;0;3;7;8;4;-4;1;2;0.50
2687;0;5;7;8;3;-5;1;8;0.12
2688;0;5;7;8;4;-4;3;8;0.38
2689;0;5;7;8;5;-3;1;8;0.12
2690;0;5;7;8;6;-2;1;8;0.12
2691;0;5;7;8;7;-1;2;8;0.25
2692;0;4;8;8;3;-5;1;4;0.25
2693;0;4;8;8;5;-3;1;4;0.25
2694;0;4;8;8;6;-2;1;4;0.25
2695;0;4;8;8;8;0;1;4;0.25
2696;0;5;8;8;3;-5;1;2;0.50
2697;0;5;8;8;8;0;1;2;0.50
2698;0;6;9;8;3;-5;1;1;1.00
2699;0;5;6;9;3;-6;1;3;0.33
2700;0;5;6;9;5;-4;1;3;0.33
2701;0;5;6;9;7;-2;1;3;0.33
2702;0;5;7;9;3;-6;1;1;1.00
2703;0;8;8;9;3;-6;1;1;1.00
2704;0;6;5;1;4;3;1;1;1.00
2705;0;6;3;2;4;2;1;2;0.50
2706;0;6;3;2;7;5;1;2;0.50
2707;0;8;3;2;4;2;1;1;1.00
2708;0;9;3;2;4;2;1;1;1.00
2709;0;7;4;2;4;2;1;1;1.00
2710;0;9;4;2;4;2;1;1;1.00
2711;0;6;5;2;4;2;1;3;0.33
2712;0;6;5;2;6;4;1;3;0.33
2713;0;6;5;2;9;7;1;3;0.33
2714;0;4;6;2;4;2;1;2;0.50
2715;0;4;6;2;6;4;1;2;0.50
2716;0;5;8;2;4;2;1;1;1.00
2717;0;4;2;3;4;1;1;2;0.50
2718;0;4;2;3;6;3;1;2;0.50
2719;0;6;2;3;4;1;1;1;1.00
2720;0;9;2;3;4;1;1;1;1.00
2721;0;4;3;3;4;1;1;4;0.25
2722;0;4;3;3;7;4;3;4;0.75
2723;0;7;3;3;4;1;1;2;0.50
2724;0;7;3;3;6;3;1;2;0.50
2725;0;8;3;3;4;1;1;2;0.50
2726;0;8;3;3;5;2;1;2;0.50
2727;0;7;5;3;4;1;2;9;0.22
2728;0;7;5;3;5;2;3;9;0.33
2729;0;7;5;3;6;3;1;9;0.11
2730;0;7;5;3;7;4;2;9;0.22
2731;0;7;5;3;8;5;1;9;0.11
2732;0;9;5;3;4;1;1;2;0.50
2733;0;9;5;3;5;2;1;2;0.50
2734;0;2;7;3;4;1;1;1;1.00
2735;0;6;7;3;4;1;2;6;0.33
2736;0;6;7;3;5;2;3;6;0.50
2737;0;6;7;3;7;4;1;6;0.17
2738;0;8;8;3;4;1;1;2;0.50
2739;0;8;8;3;6;3;1;2;0.50
2740;0;9;8;3;4;1;1;1;1.00
2741;0;4;3;4;4;0;1;3;0.33
2742;0;4;3;4;5;1;1;3;0.33
2743;0;4;3;4;6;2;1;3;0.33
2744;0;8;3;4;4;0;1;5;0.20
2745;0;8;3;4;5;1;1;5;0.20
2746;0;8;3;4;6;2;1;5;0.20
2747;0;8;3;4;8;4;2;5;0.40
2748;0;4;4;4;4;0;1;7;0.14
2749;0;4;4;4;5;1;3;7;0.43
2750;0;4;4;4;7;3;2;7;0.29
2751;0;4;4;4;8;4;1;7;0.14
2752;0;7;4;4;4;0;1;11;0.09
2753;0;7;4;4;6;2;7;11;0.64
2754;0;7;4;4;7;3;2;11;0.18
2755;0;7;4;4;8;4;1;11;0.09
2756;0;3;5;4;4;0;2;4;0.50
2757;0;3;5;4;5;1;2;4;0.50
2758;0;9;5;4;4;0;1;2;0.50
2759;0;9;5;4;6;2;1;2;0.50
2760;0;3;6;4;4;0;1;11;0.09
2761;0;3;6;4;5;1;3;11;0.27
2762;0;3;6;4;6;2;4;11;0.36
2763;0;3;6;4;7;3;1;11;0.09
2764;0;3;6;4;8;4;1;11;0.09
2765;0;3;6;4;9;5;1;11;0.09
2766;0;6;6;4;4;0;3;14;0.21
2767;0;6;6;4;5;1;3;14;0.21
2768;0;6;6;4;6;2;4;14;0.29
2769;0;6;6;4;7;3;4;14;0.29
2770;0;7;6;4;4;0;1;15;0.07
2771;0;7;6;4;5;1;4;15;0.27
2772;0;7;6;4;6;2;8;15;0.53
2773;0;7;6;4;7;3;2;15;0.13
2774;0;5;7;4;4;0;3;10;0.30
2775;0;5;7;4;5;1;4;10;0.40
2776;0;5;7;4;7;3;2;10;0.20
2777;0;5;7;4;8;4;1;10;0.10
2778;0;4;8;4;4;0;1;7;0.14
2779;0;4;8;4;6;2;1;7;0.14
2780;0;4;8;4;7;3;1;7;0.14
2781;0;4;8;4;8;4;2;7;0.29
2782;0;4;8;4;9;5;2;7;0.29
2783;0;5;3;5;4;-1;1;10;0.10
2784;0;5;3;5;5;0;3;10;0.30
2785;0;5;3;5;6;1;5;10;0.50
2786;0;5;3;5;7;2;1;10;0.10
2787;0;3;5;5;4;-1;1;8;0.12
2788;0;3;5;5;5;0;4;8;0.50
2789;0;3;5;5;6;1;2;8;0.25
2790;0;3;5;5;8;3;1;8;0.12
2791;0;8;5;5;4;-1;1;7;0.14
2792;0;8;5;5;5;0;2;7;0.29
2793;0;8;5;5;6;1;2;7;0.29
2794;0;8;5;5;7;2;1;7;0.14
2795;0;8;5;5;8;3;1;7;0.14
2796;0;7;6;5;4;-1;2;13;0.15
2797;0;7;6;5;5;0;2;13;0.15
2798;0;7;6;5;6;1;2;13;0.15
2799;0;7;6;5;7;2;4;13;0.31
2800;0;7;6;5;8;3;2;13;0.15
2801;0;7;6;5;9;4;1;13;0.08
2802;0;2;7;5;4;-1;1;1;1.00
2803;0;3;7;5;4;-1;1;6;0.17
2804;0;3;7;5;6;1;1;6;0.17
2805;0;3;7;5;7;2;2;6;0.33
2806;0;3;7;5;9;4;2;6;0.33
2807;0;4;8;5;4;-1;1;3;0.33
2808;0;4;8;5;5;0;1;3;0.33
2809;0;4;8;5;6;1;1;3;0.33
2810;0;7;8;5;4;-1;1;8;0.12
2811;0;7;8;5;5;0;3;8;0.38
2812;0;7;8;5;6;1;1;8;0.12
2813;0;7;8;5;7;2;2;8;0.25
2814;0;7;8;5;8;3;1;8;0.12
2815;0;6;9;5;4;-1;1;5;0.20
2816;0;6;9;5;5;0;2;5;0.40
2817;0;6;9;5;6;1;1;5;0.20
2818;0;6;9;5;8;3;1;5;0.20
2819;0;7;9;5;4;-1;1;2;0.50
2820;0;7;9;5;6;1;1;2;0.50
2821;0;5;10;5;4;-1;1;2;0.50
2822;0;5;10;5;5;0;1;2;0.50
2823;0;6;10;5;4;-1;1;1;1.00
2824;0;6;2;6;4;-2;1;3;0.33
2825;0;6;2;6;7;1;1;3;0.33
2826;0;6;2;6;8;2;1;3;0.33
2827;0;2;3;6;4;-2;1;2;0.50
2828;0;2;3;6;5;-1;1;2;0.50
2829;0;3;3;6;4;-2;2;4;0.50
2830;0;3;3;6;5;-1;1;4;0.25
2831;0;3;3;6;6;0;1;4;0.25
2832;0;5;3;6;4;-2;3;10;0.30
2833;0;5;3;6;5;-1;2;10;0.20
2834;0;5;3;6;6;0;2;10;0.20
2835;0;5;3;6;7;1;1;10;0.10
2836;0;5;3;6;8;2;2;10;0.20
2837;0;6;3;6;4;-2;1;9;0.11
2838;0;6;3;6;5;-1;4;9;0.44
2839;0;6;3;6;6;0;1;9;0.11
2840;0;6;3;6;7;1;2;9;0.22
2841;0;6;3;6;8;2;1;9;0.11
2842;0;7;3;6;4;-2;2;5;0.40
2843;0;7;3;6;6;0;1;5;0.20
2844;0;7;3;6;7;1;1;5;0.20
2845;0;7;3;6;8;2;1;5;0.20
2846;0;8;3;6;4;-2;1;5;0.20
2847;0;8;3;6;5;-1;2;5;0.40
2848;0;8;3;6;6;0;1;5;0.20
2849;0;8;3;6;7;1;1;5;0.20
2850;0;4;4;6;4;-2;1;14;0.07
2851;0;4;4;6;5;-1;5;14;0.36
2852;0;4;4;6;6;0;6;14;0.43
2853;0;4;4;6;8;2;2;14;0.14
2854;0;3;5;6;4;-2;1;15;0.07
2855;0;3;5;6;5;-1;6;15;0.40
2856;0;3;5;6;6;0;1;15;0.07
2857;0;3;5;6;7;1;6;15;0.40
2858;0;3;5;6;9;3;1;15;0.07
2859;0;10;7;6;4;-2;2;2;1.00
2860;0;4;8;6;4;-2;2;7;0.29
2861;0;4;8;6;5;-1;3;7;0.43
2862;0;4;8;6;6;0;1;7;0.14
2863;0;4;8;6;9;3;1;7;0.14
2864;0;8;8;6;4;-2;1;3;0.33
2865;0;8;8;6;5;-1;1;3;0.33
2866;0;8;8;6;7;1;1;3;0.33
2867;0;9;9;6;4;-2;1;1;1.00
2868;0;7;2;7;4;-3;2;4;0.50
2869;0;7;2;7;6;-1;1;4;0.25
2870;0;7;2;7;7;0;1;4;0.25
2871;0;5;3;7;4;-3;1;6;0.17
2872;0;5;3;7;6;-1;3;6;0.50
2873;0;5;3;7;7;0;1;6;0.17
2874;0;5;3;7;8;1;1;6;0.17
2875;0;7;3;7;4;-3;1;5;0.20
2876;0;7;3;7;6;-1;2;5;0.40
2877;0;7;3;7;7;0;2;5;0.40
2878;0;3;4;7;4;-3;2;6;0.33
2879;0;3;4;7;5;-2;1;6;0.17
2880;0;3;4;7;6;-1;3;6;0.50
2881;0;4;4;7;4;-3;2;10;0.20
2882;0;4;4;7;5;-2;4;10;0.40
2883;0;4;4;7;6;-1;3;10;0.30
2884;0;4;4;7;8;1;1;10;0.10
2885;0;5;4;7;4;-3;2;11;0.18
2886;0;5;4;7;5;-2;3;11;0.27
2887;0;5;4;7;6;-1;2;11;0.18
2888;0;5;4;7;7;0;2;11;0.18
2889;0;5;4;7;8;1;2;11;0.18
2890;0;8;4;7;4;-3;1;7;0.14
2891;0;8;4;7;5;-2;3;7;0.43
2892;0;8;4;7;6;-1;2;7;0.29
2893;0;8;4;7;7;0;1;7;0.14
2894;0;3;6;7;4;-3;1;6;0.17
2895;0;3;6;7;5;-2;1;6;0.17
2896;0;3;6;7;6;-1;1;6;0.17
2897;0;3;6;7;7;0;2;6;0.33
2898;0;3;6;7;8;1;1;6;0.17
2899;0;8;6;7;4;-3;1;6;0.17
2900;0;8;6;7;5;-2;3;6;0.50
2901;0;8;6;7;6;-1;1;6;0.17
2902;0;8;6;7;7;0;1;6;0.17
2903;0;9;7;7;4;-3;1;1;1.00
2904;0;6;9;7;4;-3;2;3;0.67
2905;0;6;9;7;5;-2;1;3;0.33
2906;0;7;9;7;4;-3;1;2;0.50
2907;0;7;9;7;6;-1;1;2;0.50
2908;0;6;2;8;4;-4;1;1;1.00
2909;0;8;3;8;4;-4;2;3;0.67
2910;0;8;3;8;6;-2;1;3;0.33
2911;0;3;4;8;4;-4;2;4;0.50
2912;0;3;4;8;5;-3;1;4;0.25
2913;0;3;4;8;8;0;1;4;0.25
2914;0;5;4;8;4;-4;2;5;0.40
2915;0;5;4;8;6;-2;1;5;0.20
2916;0;5;4;8;7;-1;1;5;0.20
2917;0;5;4;8;8;0;1;5;0.20
2918;0;7;5;8;4;-4;1;6;0.17
2919;0;7;5;8;5;-3;3;6;0.50
2920;0;7;5;8;6;-2;2;6;0.33
2921;0;2;6;8;4;-4;1;1;1.00
2922;0;3;6;8;4;-4;2;4;0.50
2923;0;3;6;8;6;-2;1;4;0.25
2924;0;3;6;8;8;0;1;4;0.25
2925;0;8;6;8;4;-4;1;3;0.33
2926;0;8;6;8;5;-3;1;3;0.33
2927;0;8;6;8;8;0;1;3;0.33
2928;0;6;7;8;4;-4;1;7;0.14
2929;0;6;7;8;5;-3;2;7;0.29
2930;0;6;7;8;6;-2;1;7;0.14
2931;0;6;7;8;7;-1;3;7;0.43
2932;0;7;7;8;4;-4;1;3;0.33
2933;0;7;7;8;5;-3;1;3;0.33
2934;0;7;7;8;7;-1;1;3;0.33
2935;0;8;7;8;4;-4;1;4;0.25
2936;0;8;7;8;5;-3;1;4;0.25
2937;0;8;7;8;6;-2;1;4;0.25
2938;0;8;7;8;7;-1;1;4;0.25
2939;0;3;8;8;4;-4;1;2;0.50
2940;0;3;8;8;6;-2;1;2;0.50
2941;0;7;4;9;4;-5;1;1;1.00
2942;0;8;4;9;4;-5;1;4;0.25
2943;0;8;4;9;5;-4;1;4;0.25
2944;0;8;4;9;7;-2;1;4;0.25
2945;0;8;4;9;8;-1;1;4;0.25
2946;0;4;5;9;4;-5;1;2;0.50
2947;0;4;5;9;5;-4;1;2;0.50
2948;0;5;5;9;4;-5;1;2;0.50
2949;0;5;5;9;5;-4;1;2;0.50
2950;0;6;5;9;4;-5;2;4;0.50
2951;0;6;5;9;5;-4;2;4;0.50
2952;0;7;5;9;4;-5;1;5;0.20
2953;0;7;5;9;5;-4;1;5;0.20
2954;0;7;5;9;6;-3;1;5;0.20
2955;0;7;5;9;7;-2;2;5;0.40
2956;0;8;6;9;4;-5;1;1;1.00
2957;0;7;7;9;4;-5;1;2;0.50
2958;0;7;7;9;7;-2;1;2;0.50
2959;0;8;7;9;4;-5;1;1;1.00
2960;0;8;5;10;4;-6;1;2;0.50
2961;0;8;5;10;5;-5;1;2;0.50
2962;0;6;6;10;4;-6;1;1;1.00
2963;0;3;4;1;5;4;1;1;1.00
2964;0;6;7;1;5;4;1;1;1.00
2965;0;2;9;2;5;3;1;1;1.00
2966;0;7;2;3;5;2;1;2;0.50
2967;0;7;2;3;9;6;1;2;0.50
2968;0;5;3;3;5;2;1;4;0.25
2969;0;5;3;3;6;3;2;4;0.50
2970;0;5;3;3;7;4;1;4;0.25
2971;0;6;3;3;5;2;2;4;0.50
2972;0;6;3;3;7;4;2;4;0.50
2973;0;9;3;3;5;2;1;1;1.00
2974;0;4;4;3;5;2;2;2;1.00
2975;0;3;5;3;5;2;2;3;0.67
2976;0;3;5;3;8;5;1;3;0.33
2977;0;4;5;3;5;2;1;4;0.25
2978;0;4;5;3;6;3;3;4;0.75
2979;0;8;5;3;5;2;1;2;0.50
2980;0;8;5;3;7;4;1;2;0.50
2981;0;3;8;3;5;2;1;2;0.50
2982;0;3;8;3;8;5;1;2;0.50
2983;0;5;8;3;5;2;1;3;0.33
2984;0;5;8;3;6;3;2;3;0.67
2985;0;3;2;4;5;1;1;3;0.33
2986;0;3;2;4;7;3;1;3;0.33
2987;0;3;2;4;8;4;1;3;0.33
2988;0;4;2;4;5;1;1;3;0.33
2989;0;4;2;4;6;2;2;3;0.67
2990;0;5;3;4;5;1;1;5;0.20
2991;0;5;3;4;6;2;1;5;0.20
2992;0;5;3;4;7;3;2;5;0.40
2993;0;5;3;4;8;4;1;5;0.20
2994;0;10;5;4;5;1;1;2;0.50
2995;0;10;5;4;6;2;1;2;0.50
2996;0;8;6;4;5;1;2;5;0.40
2997;0;8;6;4;6;2;1;5;0.20
2998;0;8;6;4;7;3;2;5;0.40
2999;0;9;6;4;5;1;1;3;0.33
3000;0;9;6;4;6;2;1;3;0.33
3001;0;9;6;4;8;4;1;3;0.33
3002;0;9;7;4;5;1;1;3;0.33
3003;0;9;7;4;6;2;1;3;0.33
3004;0;9;7;4;7;3;1;3;0.33
3005;0;6;9;4;5;1;1;2;0.50
3006;0;6;9;4;6;2;1;2;0.50
3007;0;5;10;4;5;1;1;1;1.00
3008;0;4;1;5;5;0;1;1;1.00
3009;0;9;2;5;5;0;1;1;1.00
3010;0;3;4;5;5;0;1;4;0.25
3011;0;3;4;5;6;1;2;4;0.50
3012;0;3;4;5;7;2;1;4;0.25
3013;0;4;4;5;5;0;2;6;0.33
3014;0;4;4;5;6;1;4;6;0.67
3015;0;2;5;5;5;0;1;1;1.00
3016;0;2;6;5;5;0;1;2;0.50
3017;0;2;6;5;7;2;1;2;0.50
3018;0;9;8;5;5;0;1;1;1.00
3019;0;2;9;5;5;0;1;1;1.00
3020;0;5;9;5;5;0;4;7;0.57
3021;0;5;9;5;6;1;2;7;0.29
3022;0;5;9;5;7;2;1;7;0.14
3023;0;7;1;6;5;-1;1;2;0.50
3024;0;7;1;6;6;0;1;2;0.50
3025;0;5;2;6;5;-1;2;3;0.67
3026;0;5;2;6;7;1;1;3;0.33
3027;0;9;5;6;5;-1;1;4;0.25
3028;0;9;5;6;6;0;2;4;0.50
3029;0;9;5;6;7;1;1;4;0.25
3030;0;1;6;6;5;-1;1;3;0.33
3031;0;1;6;6;6;0;1;3;0.33
3032;0;1;6;6;7;1;1;3;0.33
3033;0;2;7;6;5;-1;1;2;0.50
3034;0;2;7;6;9;3;1;2;0.50
3035;0;3;8;6;5;-1;1;3;0.33
3036;0;3;8;6;6;0;1;3;0.33
3037;0;3;8;6;8;2;1;3;0.33
3038;0;5;9;6;5;-1;1;1;1.00
3039;0;8;9;6;5;-1;1;1;1.00
3040;0;6;10;6;5;-1;1;1;1.00
3041;0;7;10;6;5;-1;1;1;1.00
3042;0;6;2;7;5;-2;1;1;1.00
3043;0;4;3;7;5;-2;1;2;0.50
3044;0;4;3;7;9;2;1;2;0.50
3045;0;8;3;7;5;-2;2;3;0.67
3046;0;8;3;7;6;-1;1;3;0.33
3047;0;2;4;7;5;-2;1;2;0.50
3048;0;2;4;7;7;0;1;2;0.50
3049;0;9;4;7;5;-2;1;1;1.00
3050;0;9;5;7;5;-2;2;2;1.00
3051;0;2;6;7;5;-2;1;2;0.50
3052;0;2;6;7;6;-1;1;2;0.50
3053;0;9;6;7;5;-2;2;2;1.00
3054;0;10;6;7;5;-2;1;1;1.00
3055;0;2;7;7;5;-2;1;2;0.50
3056;0;2;7;7;7;0;1;2;0.50
3057;0;4;7;7;5;-2;2;9;0.22
3058;0;4;7;7;6;-1;3;9;0.33
3059;0;4;7;7;7;0;2;9;0.22
3060;0;4;7;7;8;1;1;9;0.11
3061;0;4;7;7;9;2;1;9;0.11
3062;0;8;7;7;5;-2;1;2;0.50
3063;0;8;7;7;7;0;1;2;0.50
3064;0;4;8;7;5;-2;3;5;0.60
3065;0;4;8;7;7;0;1;5;0.20
3066;0;4;8;7;9;2;1;5;0.20
3067;0;8;8;7;5;-2;1;1;1.00
3068;0;5;9;7;5;-2;1;2;0.50
3069;0;5;9;7;8;1;1;2;0.50
3070;0;4;10;7;5;-2;1;1;1.00
3071;0;4;3;8;5;-3;1;1;1.00
3072;0;5;3;8;5;-3;1;4;0.25
3073;0;5;3;8;6;-2;1;4;0.25
3074;0;5;3;8;7;-1;2;4;0.50
3075;0;8;4;8;5;-3;1;4;0.25
3076;0;8;4;8;6;-2;2;4;0.50
3077;0;8;4;8;7;-1;1;4;0.25
3078;0;2;5;8;5;-3;1;1;1.00
3079;0;4;5;8;5;-3;1;5;0.20
3080;0;4;5;8;7;-1;3;5;0.60
3081;0;4;5;8;8;0;1;5;0.20
3082;0;7;6;8;5;-3;1;5;0.20
3083;0;7;6;8;6;-2;2;5;0.40
3084;0;7;6;8;7;-1;1;5;0.20
3085;0;7;6;8;8;0;1;5;0.20
3086;0;2;7;8;5;-3;1;1;1.00
3087;0;9;7;8;5;-3;1;1;1.00
3088;0;6;8;8;5;-3;2;3;0.67
3089;0;6;8;8;6;-2;1;3;0.33
3090;0;4;9;8;5;-3;1;1;1.00
3091;0;6;2;9;5;-4;1;1;1.00
3092;0;4;4;9;5;-4;1;2;0.50
3093;0;4;4;9;6;-3;1;2;0.50
3094;0;3;5;9;5;-4;1;1;1.00
3095;0;8;5;9;5;-4;1;1;1.00
3096;0;7;6;9;5;-4;2;4;0.50
3097;0;7;6;9;6;-3;1;4;0.25
3098;0;7;6;9;7;-2;1;4;0.25
3099;0;3;7;9;5;-4;1;1;1.00
3100;0;6;7;9;5;-4;1;2;0.50
3101;0;6;7;9;7;-2;1;2;0.50
3102;0;6;8;9;5;-4;2;3;0.67
3103;0;6;8;9;6;-3;1;3;0.33
3104;0;6;5;10;5;-5;1;1;1.00
3105;0;7;6;10;5;-5;1;1;1.00
3106;0;6;6;1;6;5;1;1;1.00
3107;0;4;7;1;6;5;1;1;1.00
3108;0;7;7;1;6;5;1;1;1.00
3109;0;7;8;1;6;5;1;1;1.00
3110;0;7;5;2;6;4;1;1;1.00
3111;0;3;6;2;6;4;1;1;1.00
3112;0;6;6;2;6;4;1;3;0.33
3113;0;6;6;2;7;5;1;3;0.33
3114;0;6;6;2;9;7;1;3;0.33
3115;0;4;1;3;6;3;1;1;1.00
3116;0;2;3;3;6;3;1;1;1.00
3117;0;3;4;3;6;3;1;2;0.50
3118;0;3;4;3;7;4;1;2;0.50
3119;0;2;5;3;6;3;1;2;0.50
3120;0;2;5;3;7;4;1;2;0.50
3121;0;4;7;3;6;3;1;1;1.00
3122;0;7;7;3;6;3;1;3;0.33
3123;0;7;7;3;7;4;2;3;0.67
3124;0;8;7;3;6;3;2;3;0.67
3125;0;8;7;3;8;5;1;3;0.33
3126;0;7;9;3;6;3;1;1;1.00
3127;0;5;2;4;6;2;2;2;1.00
3128;0;2;3;4;6;2;1;3;0.33
3129;0;2;3;4;7;3;2;3;0.67
3130;0;3;3;4;6;2;2;3;0.67
3131;0;3;3;4;7;3;1;3;0.33
3132;0;3;4;4;6;2;2;4;0.50
3133;0;3;4;4;8;4;1;4;0.25
3134;0;3;4;4;10;6;1;4;0.25
3135;0;9;4;4;6;2;1;2;0.50
3136;0;9;4;4;7;3;1;2;0.50
3137;0;2;6;4;6;2;1;1;1.00
3138;0;4;9;4;6;2;1;2;0.50
3139;0;4;9;4;7;3;1;2;0.50
3140;0;7;9;4;6;2;1;2;0.50
3141;0;7;9;4;8;4;1;2;0.50
3142;0;8;3;5;6;1;2;3;0.67
3143;0;8;3;5;7;2;1;3;0.33
3144;0;2;4;5;6;1;2;2;1.00
3145;0;8;4;5;6;1;2;4;0.50
3146;0;8;4;5;7;2;2;4;0.50
3147;0;9;4;5;6;1;1;2;0.50
3148;0;9;4;5;7;2;1;2;0.50
3149;0;10;4;5;6;1;1;1;1.00
3150;0;10;5;5;6;1;1;1;1.00
3151;0;2;8;5;6;1;1;1;1.00
3152;0;3;8;5;6;1;1;3;0.33
3153;0;3;8;5;7;2;2;3;0.67
3154;0;8;8;5;6;1;2;3;0.67
3155;0;8;8;5;9;4;1;3;0.33
3156;0;6;1;6;6;0;1;1;1.00
3157;0;8;1;6;6;0;1;1;1.00
3158;0;1;3;6;6;0;1;1;1.00
3159;0;2;4;6;6;0;3;4;0.75
3160;0;2;4;6;7;1;1;4;0.25
3161;0;2;5;6;6;0;1;1;1.00
3162;0;9;7;6;6;0;1;1;1.00
3163;0;2;8;6;6;0;1;1;1.00
3164;0;1;4;7;6;-1;1;1;1.00
3165;0;10;4;7;6;-1;1;1;1.00
3166;0;1;5;7;6;-1;1;1;1.00
3167;0;5;10;7;6;-1;1;1;1.00
3168;0;6;10;7;6;-1;1;1;1.00
3169;0;4;2;8;6;-2;1;1;1.00
3170;0;2;3;8;6;-2;1;1;1.00
3171;0;7;4;8;6;-2;2;3;0.67
3172;0;7;4;8;7;-1;1;3;0.33
3173;0;3;5;8;6;-2;4;4;1.00
3174;0;8;2;9;6;-3;1;1;1.00
3175;0;2;3;9;6;-3;1;1;1.00
3176;0;6;4;9;6;-3;1;2;0.50
3177;0;6;4;9;9;0;1;2;0.50
3178;0;6;6;9;6;-3;2;3;0.67
3179;0;6;6;9;8;-1;1;3;0.33
3180;0;4;9;9;6;-3;1;1;1.00
3181;0;7;5;10;6;-4;1;1;1.00
3182;0;4;6;10;6;-4;1;1;1.00
3183;0;3;7;10;6;-4;1;1;1.00
3184;0;4;2;2;7;5;1;1;1.00
3185;0;3;5;2;7;5;1;2;0.50
3186;0;3;5;2;8;6;1;2;0.50
3187;0;6;7;2;7;5;1;1;1.00
3188;0;7;7;2;7;5;1;1;1.00
3189;0;8;7;2;7;5;1;1;1.00
3190;0;3;6;3;7;4;1;1;1.00
3191;0;4;8;3;7;4;1;1;1.00
3192;0;7;8;3;7;4;1;3;0.33
3193;0;7;8;3;8;5;2;3;0.67
3194;0;5;1;4;7;3;1;1;1.00
3195;0;6;2;4;7;3;1;1;1.00
3196;0;2;8;4;7;3;1;1;1.00
3197;0;3;8;4;7;3;2;3;0.67
3198;0;3;8;4;9;5;1;3;0.33
3199;0;8;8;4;7;3;1;1;1.00
3200;0;6;10;4;7;3;1;1;1.00
3201;0;7;1;5;7;2;1;1;1.00
3202;0;2;3;5;7;2;1;1;1.00
3203;0;1;5;5;7;2;1;1;1.00
3204;0;1;6;5;7;2;1;1;1.00
3205;0;10;6;5;7;2;1;2;0.50
3206;0;10;6;5;8;3;1;2;0.50
3207;0;10;7;5;7;2;1;1;1.00
3208;0;8;7;6;7;1;1;1;1.00
3209;0;2;9;6;7;1;1;1;1.00
3210;0;3;9;6;7;1;1;1;1.00
3211;0;5;10;6;7;1;1;1;1.00
3212;0;2;2;7;7;0;1;1;1.00
3213;0;4;9;7;7;0;1;1;1.00
3214;0;9;4;8;7;-1;1;1;1.00
3215;0;9;5;8;7;-1;1;1;1.00
3216;0;8;8;8;7;-1;1;2;0.50
3217;0;8;8;8;9;1;1;2;0.50
3218;0;4;4;10;7;-3;1;1;1.00
3219;0;5;5;10;7;-3;1;1;1.00
3220;0;5;6;10;7;-3;1;1;1.00
3221;0;3;4;2;8;6;1;1;1.00
3222;0;5;6;2;8;6;1;1;1.00
3223;0;8;2;3;8;5;1;1;1.00
3224;0;8;2;4;8;4;1;1;1.00
3225;0;8;2;5;8;3;1;1;1.00
3226;0;3;2;7;8;1;1;1;1.00
3227;0;6;8;2;9;7;1;1;1.00
3228;0;0;3;4;1;-3;1;34;0.03
3229;0;0;3;4;2;-2;1;34;0.03
3230;0;0;3;4;3;-1;2;34;0.06
3231;0;0;3;4;4;0;4;34;0.12
3232;0;0;3;4;5;1;4;34;0.12
3233;0;0;3;4;6;2;12;34;0.35
3234;0;0;3;4;7;3;6;34;0.18
3235;0;0;3;4;8;4;4;34;0.12
3236;0;0;5;4;1;-3;1;74;0.01
3237;0;0;5;4;2;-2;2;74;0.03
3238;0;0;5;4;3;-1;4;74;0.05
3239;0;0;5;4;4;0;14;74;0.19
3240;0;0;5;4;5;1;16;74;0.22
3241;0;0;5;4;6;2;21;74;0.28
3242;0;0;5;4;7;3;11;74;0.15
3243;0;0;5;4;8;4;5;74;0.07
3244;0;0;6;5;1;-4;1;120;0.01
3245;0;0;6;5;2;-3;3;120;0.03
3246;0;0;6;5;3;-2;7;120;0.06
3247;0;0;6;5;4;-1;16;120;0.13
3248;0;0;6;5;5;0;29;120;0.24
3249;0;0;6;5;6;1;29;120;0.24
3250;0;0;6;5;7;2;21;120;0.17
3251;0;0;6;5;8;3;9;120;0.07
3252;0;0;6;5;9;4;4;120;0.03
3253;0;0;6;5;10;5;1;120;0.01
3254;0;0;6;6;1;-5;1;120;0.01
3255;0;0;6;6;2;-4;3;120;0.03
3256;0;0;6;6;3;-3;14;120;0.12
3257;0;0;6;6;4;-2;14;120;0.12
3258;0;0;6;6;5;-1;28;120;0.23
3259;0;0;6;6;6;0;28;120;0.23
3260;0;0;6;6;7;1;19;120;0.16
3261;0;0;6;6;8;2;9;120;0.07
3262;0;0;6;6;9;3;3;120;0.03
3263;0;0;6;6;10;4;1;120;0.01
3264;0;0;4;7;1;-6;1;64;0.02
3265;0;0;4;7;2;-5;2;64;0.03
3266;0;0;4;7;3;-4;1;64;0.02
3267;0;0;4;7;4;-3;12;64;0.19
3268;0;0;4;7;5;-2;17;64;0.27
3269;0;0;4;7;6;-1;16;64;0.25
3270;0;0;4;7;7;0;9;64;0.14
3271;0;0;4;7;8;1;6;64;0.09
3272;0;0;6;7;1;-6;1;90;0.01
3273;0;0;6;7;2;-5;1;90;0.01
3274;0;0;6;7;3;-4;6;90;0.07
3275;0;0;6;7;4;-3;17;90;0.19
3276;0;0;6;7;5;-2;26;90;0.29
3277;0;0;6;7;6;-1;14;90;0.16
3278;0;0;6;7;7;0;16;90;0.18
3279;0;0;6;7;8;1;7;90;0.08
3280;0;0;6;7;9;2;2;90;0.02
3281;0;0;7;7;1;-6;1;54;0.02
3282;0;0;7;7;2;-5;1;54;0.02
3283;0;0;7;7;3;-4;3;54;0.06
3284;0;0;7;7;4;-3;12;54;0.22
3285;0;0;7;7;5;-2;12;54;0.22
3286;0;0;7;7;6;-1;14;54;0.26
3287;0;0;7;7;7;0;6;54;0.11
3288;0;0;7;7;8;1;3;54;0.06
3289;0;0;7;7;9;2;2;54;0.04
3290;0;0;7;8;1;-7;1;32;0.03
3291;0;0;7;8;3;-5;3;32;0.09
3292;0;0;7;8;4;-4;8;32;0.25
3293;0;0;7;8;5;-3;8;32;0.25
3294;0;0;7;8;6;-2;3;32;0.09
3295;0;0;7;8;7;-1;9;32;0.28
3296;0;0;4;2;2;0;1;10;0.10
3297;0;0;4;2;3;1;2;10;0.20
3298;0;0;4;2;4;2;3;10;0.30
3299;0;0;4;2;5;3;3;10;0.30
3300;0;0;4;2;8;6;1;10;0.10
3301;0;0;6;3;2;-1;2;43;0.05
3302;0;0;6;3;3;0;4;43;0.09
3303;0;0;6;3;4;1;6;43;0.14
3304;0;0;6;3;5;2;9;43;0.21
3305;0;0;6;3;6;3;9;43;0.21
3306;0;0;6;3;7;4;11;43;0.26
3307;0;0;6;3;8;5;2;43;0.05
3308;0;0;8;3;2;-1;1;22;0.05
3309;0;0;8;3;3;0;2;22;0.09
3310;0;0;8;3;4;1;5;22;0.23
3311;0;0;8;3;5;2;3;22;0.14
3312;0;0;8;3;6;3;5;22;0.23
3313;0;0;8;3;7;4;3;22;0.14
3314;0;0;8;3;8;5;3;22;0.14
3315;0;0;9;3;2;-1;1;3;0.33
3316;0;0;9;3;3;0;1;3;0.33
3317;0;0;9;3;6;3;1;3;0.33
3318;0;0;4;4;2;-2;4;53;0.08
3319;0;0;4;4;3;-1;2;53;0.04
3320;0;0;4;4;4;0;7;53;0.13
3321;0;0;4;4;5;1;6;53;0.11
3322;0;0;4;4;6;2;14;53;0.26
3323;0;0;4;4;7;3;10;53;0.19
3324;0;0;4;4;8;4;7;53;0.13
3325;0;0;4;4;9;5;2;53;0.04
3326;0;0;4;4;10;6;1;53;0.02
3327;0;0;7;4;2;-2;1;71;0.01
3328;0;0;7;4;3;-1;9;71;0.13
3329;0;0;7;4;4;0;11;71;0.15
3330;0;0;7;4;5;1;14;71;0.20
3331;0;0;7;4;6;2;21;71;0.30
3332;0;0;7;4;7;3;11;71;0.15
3333;0;0;7;4;8;4;3;71;0.04
3334;0;0;7;4;9;5;1;71;0.01
3335;0;0;8;4;2;-2;1;35;0.03
3336;0;0;8;4;3;-1;4;35;0.11
3337;0;0;8;4;4;0;3;35;0.09
3338;0;0;8;4;5;1;4;35;0.11
3339;0;0;8;4;6;2;8;35;0.23
3340;0;0;8;4;7;3;7;35;0.20
3341;0;0;8;4;8;4;4;35;0.11
3342;0;0;8;4;9;5;4;35;0.11
3343;0;0;9;4;2;-2;1;11;0.09
3344;0;0;9;4;4;0;2;11;0.18
3345;0;0;9;4;5;1;2;11;0.18
3346;0;0;9;4;6;2;4;11;0.36
3347;0;0;9;4;7;3;1;11;0.09
3348;0;0;9;4;8;4;1;11;0.09
3349;0;0;3;5;2;-3;2;47;0.04
3350;0;0;3;5;3;-2;3;47;0.06
3351;0;0;3;5;4;-1;4;47;0.09
3352;0;0;3;5;5;0;8;47;0.17
3353;0;0;3;5;6;1;15;47;0.32
3354;0;0;3;5;7;2;10;47;0.21
3355;0;0;3;5;8;3;4;47;0.09
3356;0;0;3;5;9;4;1;47;0.02
3357;0;0;4;5;2;-3;1;71;0.01
3358;0;0;4;5;3;-2;4;71;0.06
3359;0;0;4;5;4;-1;11;71;0.15
3360;0;0;4;5;5;0;14;71;0.20
3361;0;0;4;5;6;1;21;71;0.30
3362;0;0;4;5;7;2;13;71;0.18
3363;0;0;4;5;8;3;5;71;0.07
3364;0;0;4;5;9;4;2;71;0.03
3365;0;0;5;5;2;-3;5;122;0.04
3366;0;0;5;5;3;-2;10;122;0.08
3367;0;0;5;5;4;-1;16;122;0.13
3368;0;0;5;5;5;0;31;122;0.25
3369;0;0;5;5;6;1;27;122;0.22
3370;0;0;5;5;7;2;18;122;0.15
3371;0;0;5;5;8;3;12;122;0.10
3372;0;0;5;5;9;4;2;122;0.02
3373;0;0;5;5;10;5;1;122;0.01
3374;0;0;7;5;2;-3;1;99;0.01
3375;0;0;7;5;3;-2;9;99;0.09
3376;0;0;7;5;4;-1;16;99;0.16
3377;0;0;7;5;5;0;22;99;0.22
3378;0;0;7;5;6;1;21;99;0.21
3379;0;0;7;5;7;2;18;99;0.18
3380;0;0;7;5;8;3;6;99;0.06
3381;0;0;7;5;9;4;5;99;0.05
3382;0;0;7;5;10;5;1;99;0.01
3383;0;0;3;6;2;-4;1;42;0.02
3384;0;0;3;6;3;-3;1;42;0.02
3385;0;0;3;6;4;-2;11;42;0.26
3386;0;0;3;6;5;-1;11;42;0.26
3387;0;0;3;6;6;0;8;42;0.19
3388;0;0;3;6;7;1;6;42;0.14
3389;0;0;3;6;8;2;4;42;0.10
3390;0;0;4;6;2;-4;2;111;0.02
3391;0;0;4;6;3;-3;7;111;0.06
3392;0;0;4;6;4;-2;18;111;0.16
3393;0;0;4;6;5;-1;22;111;0.20
3394;0;0;4;6;6;0;37;111;0.33
3395;0;0;4;6;7;1;11;111;0.10
3396;0;0;4;6;8;2;8;111;0.07
3397;0;0;4;6;9;3;5;111;0.05
3398;0;0;4;6;10;4;1;111;0.01
3399;0;0;5;6;2;-4;1;129;0.01
3400;0;0;5;6;3;-3;8;129;0.06
3401;0;0;5;6;4;-2;22;129;0.17
3402;0;0;5;6;5;-1;31;129;0.24
3403;0;0;5;6;6;0;24;129;0.19
3404;0;0;5;6;7;1;29;129;0.22
3405;0;0;5;6;8;2;10;129;0.08
3406;0;0;5;6;9;3;3;129;0.02
3407;0;0;5;6;10;4;1;129;0.01
3408;0;0;7;6;2;-4;1;74;0.01
3409;0;0;7;6;3;-3;7;74;0.09
3410;0;0;7;6;4;-2;15;74;0.20
3411;0;0;7;6;5;-1;13;74;0.18
3412;0;0;7;6;6;0;14;74;0.19
3413;0;0;7;6;7;1;14;74;0.19
3414;0;0;7;6;8;2;5;74;0.07
3415;0;0;7;6;9;3;4;74;0.05
3416;0;0;7;6;10;4;1;74;0.01
3417;0;0;5;7;2;-5;3;89;0.03
3418;0;0;5;7;3;-4;12;89;0.13
3419;0;0;5;7;4;-3;10;89;0.11
3420;0;0;5;7;5;-2;24;89;0.27
3421;0;0;5;7;6;-1;17;89;0.19
3422;0;0;5;7;7;0;14;89;0.16
3423;0;0;5;7;8;1;8;89;0.09
3424;0;0;5;7;9;2;1;89;0.01
3425;0;0;8;7;2;-5;1;28;0.04
3426;0;0;8;7;3;-4;3;28;0.11
3427;0;0;8;7;4;-3;6;28;0.21
3428;0;0;8;7;5;-2;10;28;0.36
3429;0;0;8;7;6;-1;1;28;0.04
3430;0;0;8;7;7;0;2;28;0.07
3431;0;0;8;7;8;1;4;28;0.14
3432;0;0;8;7;9;2;1;28;0.04
3433;0;0;4;8;2;-6;2;29;0.07
3434;0;0;4;8;3;-5;1;29;0.03
3435;0;0;4;8;4;-4;7;29;0.24
3436;0;0;4;8;5;-3;3;29;0.10
3437;0;0;4;8;6;-2;7;29;0.24
3438;0;0;4;8;7;-1;5;29;0.17
3439;0;0;4;8;8;0;4;29;0.14
3440;0;0;5;8;2;-6;1;40;0.03
3441;0;0;5;8;3;-5;3;40;0.07
3442;0;0;5;8;4;-4;6;40;0.15
3443;0;0;5;8;5;-3;11;40;0.28
3444;0;0;5;8;6;-2;10;40;0.25
3445;0;0;5;8;7;-1;7;40;0.17
3446;0;0;5;8;8;0;2;40;0.05
3447;0;0;6;8;2;-6;1;40;0.03
3448;0;0;6;8;3;-5;9;40;0.23
3449;0;0;6;8;4;-4;9;40;0.23
3450;0;0;6;8;5;-3;6;40;0.15
3451;0;0;6;8;6;-2;5;40;0.12
3452;0;0;6;8;7;-1;4;40;0.10
3453;0;0;6;8;8;0;3;40;0.07
3454;0;0;6;8;9;1;3;40;0.07
3455;0;0;2;9;2;-7;1;3;0.33
3456;0;0;2;9;5;-4;1;3;0.33
3457;0;0;2;9;6;-3;1;3;0.33
3458;0;0;6;9;2;-7;1;16;0.06
3459;0;0;6;9;3;-6;1;16;0.06
3460;0;0;6;9;4;-5;2;16;0.12
3461;0;0;6;9;5;-4;5;16;0.31
3462;0;0;6;9;6;-3;3;16;0.19
3463;0;0;6;9;7;-2;3;16;0.19
3464;0;0;6;9;8;-1;1;16;0.06
3465;0;0;4;1;3;2;1;2;0.50
3466;0;0;4;1;5;4;1;2;0.50
3467;0;0;5;2;3;1;2;12;0.17
3468;0;0;5;2;4;2;2;12;0.17
3469;0;0;5;2;6;4;3;12;0.25
3470;0;0;5;2;7;5;2;12;0.17
3471;0;0;5;2;8;6;2;12;0.17
3472;0;0;5;2;9;7;1;12;0.08
3473;0;0;6;2;3;1;1;8;0.12
3474;0;0;6;2;4;2;1;8;0.12
3475;0;0;6;2;6;4;3;8;0.38
3476;0;0;6;2;7;5;1;8;0.12
3477;0;0;6;2;8;6;1;8;0.12
3478;0;0;6;2;9;7;1;8;0.12
3479;0;0;7;2;3;1;2;8;0.25
3480;0;0;7;2;5;3;2;8;0.25
3481;0;0;7;2;7;5;4;8;0.50
3482;0;0;8;2;3;1;1;4;0.25
3483;0;0;8;2;4;2;1;4;0.25
3484;0;0;8;2;5;3;1;4;0.25
3485;0;0;8;2;9;7;1;4;0.25
3486;0;0;9;2;3;1;1;2;0.50
3487;0;0;9;2;5;3;1;2;0.50
3488;0;0;2;3;3;0;1;9;0.11
3489;0;0;2;3;4;1;3;9;0.33
3490;0;0;2;3;5;2;1;9;0.11
3491;0;0;2;3;6;3;2;9;0.22
3492;0;0;2;3;8;5;1;9;0.11
3493;0;0;2;3;9;6;1;9;0.11
3494;0;0;4;3;3;0;4;29;0.14
3495;0;0;4;3;4;1;3;29;0.10
3496;0;0;4;3;5;2;14;29;0.48
3497;0;0;4;3;6;3;5;29;0.17
3498;0;0;4;3;7;4;2;29;0.07
3499;0;0;4;3;8;5;1;29;0.03
3500;0;0;5;3;3;0;4;39;0.10
3501;0;0;5;3;4;1;5;39;0.13
3502;0;0;5;3;5;2;10;39;0.26
3503;0;0;5;3;6;3;10;39;0.26
3504;0;0;5;3;7;4;6;39;0.15
3505;0;0;5;3;8;5;4;39;0.10
3506;0;0;7;3;3;0;2;29;0.07
3507;0;0;7;3;4;1;9;29;0.31
3508;0;0;7;3;5;2;4;29;0.14
3509;0;0;7;3;6;3;5;29;0.17
3510;0;0;7;3;7;4;5;29;0.17
3511;0;0;7;3;8;5;4;29;0.14
3512;0;0;6;4;3;-1;8;89;0.09
3513;0;0;6;4;4;0;13;89;0.15
3514;0;0;6;4;5;1;22;89;0.25
3515;0;0;6;4;6;2;27;89;0.30
3516;0;0;6;4;7;3;14;89;0.16
3517;0;0;6;4;8;4;3;89;0.03
3518;0;0;6;4;9;5;2;89;0.02
3519;0;0;2;5;3;-2;2;7;0.29
3520;0;0;2;5;4;-1;2;7;0.29
3521;0;0;2;5;5;0;1;7;0.14
3522;0;0;2;5;6;1;1;7;0.14
3523;0;0;2;5;8;3;1;7;0.14
3524;0;0;8;5;3;-2;2;36;0.06
3525;0;0;8;5;4;-1;5;36;0.14
3526;0;0;8;5;5;0;7;36;0.19
3527;0;0;8;5;6;1;11;36;0.31
3528;0;0;8;5;7;2;6;36;0.17
3529;0;0;8;5;8;3;2;36;0.06
3530;0;0;8;5;9;4;1;36;0.03
3531;0;0;8;5;10;5;2;36;0.06
3532;0;0;9;5;3;-2;2;19;0.11
3533;0;0;9;5;4;-1;2;19;0.11
3534;0;0;9;5;5;0;8;19;0.42
3535;0;0;9;5;6;1;4;19;0.21
3536;0;0;9;5;7;2;2;19;0.11
3537;0;0;9;5;8;3;1;19;0.05
3538;0;0;8;6;3;-3;3;32;0.09
3539;0;0;8;6;4;-2;5;32;0.16
3540;0;0;8;6;5;-1;8;32;0.25
3541;0;0;8;6;6;0;6;32;0.19
3542;0;0;8;6;7;1;6;32;0.19
3543;0;0;8;6;8;2;3;32;0.09
3544;0;0;8;6;9;3;1;32;0.03
3545;0;0;9;6;3;-3;3;10;0.30
3546;0;0;9;6;4;-2;3;10;0.30
3547;0;0;9;6;5;-1;2;10;0.20
3548;0;0;9;6;7;1;2;10;0.20
3549;0;0;2;7;3;-4;1;9;0.11
3550;0;0;2;7;4;-3;2;9;0.22
3551;0;0;2;7;5;-2;1;9;0.11
3552;0;0;2;7;6;-1;2;9;0.22
3553;0;0;2;7;7;0;2;9;0.22
3554;0;0;2;7;8;1;1;9;0.11
3555;0;0;3;7;3;-4;3;33;0.09
3556;0;0;3;7;4;-3;9;33;0.27
3557;0;0;3;7;5;-2;6;33;0.18
3558;0;0;3;7;6;-1;7;33;0.21
3559;0;0;3;7;7;0;4;33;0.12
3560;0;0;3;7;8;1;2;33;0.06
3561;0;0;3;7;9;2;1;33;0.03
3562;0;0;3;7;10;3;1;33;0.03
3563;0;0;2;8;3;-5;1;4;0.25
3564;0;0;2;8;4;-4;1;4;0.25
3565;0;0;2;8;5;-3;1;4;0.25
3566;0;0;2;8;6;-2;1;4;0.25
3567;0;0;3;8;3;-5;2;15;0.13
3568;0;0;3;8;4;-4;3;15;0.20
3569;0;0;3;8;5;-3;3;15;0.20
3570;0;0;3;8;6;-2;3;15;0.20
3571;0;0;3;8;7;-1;2;15;0.13
3572;0;0;3;8;8;0;2;15;0.13
3573;0;0;8;8;3;-5;2;13;0.15
3574;0;0;8;8;4;-4;1;13;0.08
3575;0;0;8;8;5;-3;3;13;0.23
3576;0;0;8;8;6;-2;3;13;0.23
3577;0;0;8;8;7;-1;1;13;0.08
3578;0;0;8;8;8;0;2;13;0.15
3579;0;0;8;8;9;1;1;13;0.08
3580;0;0;9;8;3;-5;1;2;0.50
3581;0;0;9;8;5;-3;1;2;0.50
3582;0;0;7;9;3;-6;1;7;0.14
3583;0;0;7;9;4;-5;2;7;0.29
3584;0;0;7;9;5;-4;2;7;0.29
3585;0;0;7;9;7;-2;2;7;0.29
3586;0;0;8;9;3;-6;1;4;0.25
3587;0;0;8;9;5;-4;2;4;0.50
3588;0;0;8;9;6;-3;1;4;0.25
3589;0;0;5;1;4;3;1;1;1.00
3590;0;0;3;2;4;2;3;4;0.75
3591;0;0;3;2;7;5;1;4;0.25
3592;0;0;3;3;4;1;3;19;0.16
3593;0;0;3;3;5;2;6;19;0.32
3594;0;0;3;3;6;3;4;19;0.21
3595;0;0;3;3;7;4;6;19;0.32
3596;0;0;10;5;4;-1;2;3;0.67
3597;0;0;10;5;5;0;1;3;0.33
3598;0;0;2;6;4;-2;1;6;0.17
3599;0;0;2;6;5;-1;2;6;0.33
3600;0;0;2;6;7;1;2;6;0.33
3601;0;0;2;6;8;2;1;6;0.17
3602;0;0;9;7;4;-3;3;8;0.38
3603;0;0;9;7;5;-2;2;8;0.25
3604;0;0;9;7;6;-1;1;8;0.12
3605;0;0;9;7;7;0;1;8;0.12
3606;0;0;9;7;8;1;1;8;0.12
3607;0;0;4;9;4;-5;2;9;0.22
3608;0;0;4;9;5;-4;2;9;0.22
3609;0;0;4;9;6;-3;2;9;0.22
3610;0;0;4;9;7;-2;1;9;0.11
3611;0;0;4;9;8;-1;1;9;0.11
3612;0;0;4;9;9;0;1;9;0.11
3613;0;0;5;9;4;-5;5;15;0.33
3614;0;0;5;9;5;-4;7;15;0.47
3615;0;0;5;9;6;-3;1;15;0.07
3616;0;0;5;9;7;-2;2;15;0.13
3617;0;0;5;10;4;-6;1;5;0.20
3618;0;0;5;10;5;-5;2;5;0.40
3619;0;0;5;10;6;-4;1;5;0.20
3620;0;0;5;10;7;-3;1;5;0.20
3621;0;0;6;10;4;-6;1;4;0.25
3622;0;0;6;10;5;-5;1;4;0.25
3623;0;0;6;10;6;-4;1;4;0.25
3624;0;0;6;10;7;-3;1;4;0.25
3625;0;0;7;1;5;4;1;3;0.33
3626;0;0;7;1;6;5;2;3;0.67
3627;0;0;2;4;5;1;2;10;0.20
3628;0;0;2;4;6;2;4;10;0.40
3629;0;0;2;4;7;3;2;10;0.20
3630;0;0;2;4;8;4;2;10;0.20
3631;0;0;10;4;5;1;1;2;0.50
3632;0;0;10;4;7;3;1;2;0.50
3633;0;0;1;5;5;0;1;2;0.50
3634;0;0;1;5;7;2;1;2;0.50
3635;0;0;1;6;5;-1;1;4;0.25
3636;0;0;1;6;6;0;3;4;0.75
3637;0;0;10;6;5;-1;2;3;0.67
3638;0;0;10;6;7;1;1;3;0.33
3639;0;0;10;7;5;-2;1;3;0.33
3640;0;0;10;7;6;-1;2;3;0.67
3641;0;0;6;1;6;5;1;1;1.00
3642;0;0;8;1;6;5;1;1;1.00
3643;0;0;1;3;6;3;1;1;1.00
3644;0;0;3;9;6;-3;1;1;1.00
3645;0;0;9;9;6;-3;1;1;1.00
3646;0;0;7;10;6;-4;1;1;1.00
3647;0;0;2;2;7;5;1;1;1.00
3648;0;0;1;4;7;3;1;1;1.00
3649;0;0;4;10;7;-3;1;1;1.00
